Census Year,CountyFIPSCode,Economic Development Region,Workforce Development Area,County Name,County Code,Age Range,Gender,Total Population,No High School Diploma,High School Diploma Or Equivalent,Some College No Degree,Associate's Degree,Bachelor's Degree,Graduate or Professional Degree,BachelorDegreeAndMore,Total Post-Secondary Degrees,latitude,longitude
01/01/2014 12:00:00 AM,42049,Northwest,Northwest WDA,Erie,25,45 to 64 Years,Female,38871,2639,16115,6110,3934,5891,4182,10073,14007,41.9941379,-80.0407591
01/01/2015 12:00:00 AM,42049,Northwest,Northwest WDA,Erie,25,45 to 64 Years,Female,38822,2676,15863,6235,4021,6064,3963,10027,14048,41.9941379,-80.0407591
01/01/2016 12:00:00 AM,42049,Northwest,Northwest WDA,Erie,25,45 to 64 Years,Female,38556,2634,15293,6218,4171,6324,3916,10240,14411,41.9941379,-80.0407591
01/01/2010 12:00:00 AM,42049,Northwest,Northwest WDA,Erie,25,45 to 64 Years,Male,37104,3451,15838,6056,2608,5238,3913,9151,11759,41.9941379,-80.0407591
01/01/2011 12:00:00 AM,42049,Northwest,Northwest WDA,Erie,25,45 to 64 Years,Male,37542,3592,16152,6180,2420,5312,3886,9198,11618,41.9941379,-80.0407591
01/01/2013 12:00:00 AM,42049,Northwest,Northwest WDA,Erie,25,45 to 64 Years,Female,38798,2761,16182,6141,4022,5824,3868,9692,13714,41.9941379,-80.0407591
01/01/2012 12:00:00 AM,42049,Northwest,Northwest WDA,Erie,25,45 to 64 Years,Female,38558,2711,16561,6265,3804,5354,3863,9217,13021,41.9941379,-80.0407591
01/01/2011 12:00:00 AM,42049,Northwest,Northwest WDA,Erie,25,45 to 64 Years,Female,38274,2830,16462,6455,3432,5326,3769,9095,12527,41.9941379,-80.0407591
01/01/2010 12:00:00 AM,42049,Northwest,Northwest WDA,Erie,25,45 to 64 Years,Female,37812,2940,16473,6286,3234,5122,3757,8879,12113,41.9941379,-80.0407591
01/01/2012 12:00:00 AM,42049,Northwest,Northwest WDA,Erie,25,45 to 64 Years,Male,37868,3511,16315,6329,2591,5393,3729,9122,11713,41.9941379,-80.0407591
01/01/2013 12:00:00 AM,42049,Northwest,Northwest WDA,Erie,25,45 to 64 Years,Male,38101,3579,16579,6102,2673,5524,3644,9168,11841,41.9941379,-80.0407591
01/01/2014 12:00:00 AM,42049,Northwest,Northwest WDA,Erie,25,45 to 64 Years,Male,38118,3675,16602,5886,2548,5910,3497,9407,11955,41.9941379,-80.0407591
01/01/2015 12:00:00 AM,42049,Northwest,Northwest WDA,Erie,25,45 to 64 Years,Male,38026,3372,16537,5900,2930,5875,3412,9287,12217,41.9941379,-80.0407591
01/01/2016 12:00:00 AM,42049,Northwest,Northwest WDA,Erie,25,45 to 64 Years,Male,37691,3151,16220,5962,2905,6201,3252,9453,12358,41.9941379,-80.0407591
01/01/2015 12:00:00 AM,42049,Northwest,Northwest WDA,Erie,25,25 to 34 Years,Female,17262,1331,4788,2747,1949,4282,2165,6447,8396,41.9941379,-80.0407591
01/01/2016 12:00:00 AM,42049,Northwest,Northwest WDA,Erie,25,25 to 34 Years,Female,17562,1425,4921,2844,1821,4421,2130,6551,8372,41.9941379,-80.0407591
01/01/2014 12:00:00 AM,42049,Northwest,Northwest WDA,Erie,25,25 to 34 Years,Female,16908,1117,4867,2604,1984,4226,2110,6336,8320,41.9941379,-80.0407591
01/01/2016 12:00:00 AM,42049,Northwest,Northwest WDA,Erie,25,35 to 44 Years,Female,15828,967,4489,2544,2006,3787,2035,5822,7828,41.9941379,-80.0407591
01/01/2011 12:00:00 AM,42049,Northwest,Northwest WDA,Erie,25,25 to 34 Years,Female,16014,808,4916,3021,1695,3717,1857,5574,7269,41.9941379,-80.0407591
01/01/2013 12:00:00 AM,42049,Northwest,Northwest WDA,Erie,25,25 to 34 Years,Female,16570,966,4887,2802,1928,4144,1843,5987,7915,41.9941379,-80.0407591
01/01/2012 12:00:00 AM,42049,Northwest,Northwest WDA,Erie,25,25 to 34 Years,Female,16239,885,4888,2919,1754,4026,1767,5793,7547,41.9941379,-80.0407591
01/01/2012 12:00:00 AM,42049,Northwest,Northwest WDA,Erie,25,35 to 44 Years,Female,16984,1060,5569,3329,2033,3226,1767,4993,7026,41.9941379,-80.0407591
01/01/2015 12:00:00 AM,42049,Northwest,Northwest WDA,Erie,25,35 to 44 Years,Female,16082,860,4801,2787,2090,3787,1757,5544,7634,41.9941379,-80.0407591
01/01/2014 12:00:00 AM,42049,Northwest,Northwest WDA,Erie,25,35 to 44 Years,Female,16311,979,5023,2984,2205,3369,1751,5120,7325,41.9941379,-80.0407591
01/01/2013 12:00:00 AM,42049,Northwest,Northwest WDA,Erie,25,35 to 44 Years,Female,16623,1011,5663,2975,2072,3208,1694,4902,6974,41.9941379,-80.0407591
01/01/2010 12:00:00 AM,42049,Northwest,Northwest WDA,Erie,25,25 to 34 Years,Female,15986,927,4964,3172,1646,3601,1676,5277,6923,41.9941379,-80.0407591
01/01/2011 12:00:00 AM,42049,Northwest,Northwest WDA,Erie,25,35 to 44 Years,Female,17337,1248,6001,3256,2088,3185,1559,4744,6832,41.9941379,-80.0407591
01/01/2010 12:00:00 AM,42049,Northwest,Northwest WDA,Erie,25,35 to 44 Years,Female,17723,1250,6737,2810,1985,3393,1548,4941,6926,41.9941379,-80.0407591
01/01/2016 12:00:00 AM,42049,Northwest,Northwest WDA,Erie,25,35 to 44 Years,Male,15755,1341,6292,2449,1396,2968,1309,4277,5673,41.9941379,-80.0407591
01/01/2013 12:00:00 AM,42049,Northwest,Northwest WDA,Erie,25,25 to 34 Years,Male,17166,1371,5982,3296,1456,3769,1292,5061,6517,41.9941379,-80.0407591
01/01/2015 12:00:00 AM,42049,Northwest,Northwest WDA,Erie,25,35 to 44 Years,Male,15972,1375,6447,2581,1536,2749,1284,4033,5569,41.9941379,-80.0407591
01/01/2010 12:00:00 AM,42049,Northwest,Northwest WDA,Erie,25,35 to 44 Years,Male,17606,1498,7548,3129,1245,3000,1186,4186,5431,41.9941379,-80.0407591
01/01/2013 12:00:00 AM,42049,Northwest,Northwest WDA,Erie,25,35 to 44 Years,Male,16625,1844,6661,2865,1321,2748,1186,3934,5255,41.9941379,-80.0407591
01/01/2014 12:00:00 AM,42049,Northwest,Northwest WDA,Erie,25,35 to 44 Years,Male,16300,1554,6766,2758,1443,2596,1183,3779,5222,41.9941379,-80.0407591
01/01/2012 12:00:00 AM,42049,Northwest,Northwest WDA,Erie,25,35 to 44 Years,Male,16895,1680,6795,3151,1183,2911,1175,4086,5269,41.9941379,-80.0407591
01/01/2011 12:00:00 AM,42049,Northwest,Northwest WDA,Erie,25,35 to 44 Years,Male,17281,1544,7282,3198,1258,2831,1168,3999,5257,41.9941379,-80.0407591
01/01/2014 12:00:00 AM,42049,Northwest,Northwest WDA,Erie,25,25 to 34 Years,Male,17545,1357,6348,3288,1426,3968,1158,5126,6552,41.9941379,-80.0407591
01/01/2012 12:00:00 AM,42049,Northwest,Northwest WDA,Erie,25,25 to 34 Years,Male,16748,1285,6363,3485,1203,3304,1108,4412,5615,41.9941379,-80.0407591
01/01/2016 12:00:00 AM,42049,Northwest,Northwest WDA,Erie,25,25 to 34 Years,Male,18408,1440,6518,3125,1551,4674,1100,5774,7325,41.9941379,-80.0407591
01/01/2015 12:00:00 AM,42049,Northwest,Northwest WDA,Erie,25,25 to 34 Years,Male,17994,1396,6277,3287,1624,4329,1081,5410,7034,41.9941379,-80.0407591
01/01/2010 12:00:00 AM,42049,Northwest,Northwest WDA,Erie,25,25 to 34 Years,Male,16410,1495,7043,2705,1126,2975,1066,4041,5167,41.9941379,-80.0407591
01/01/2011 12:00:00 AM,42049,Northwest,Northwest WDA,Erie,25,25 to 34 Years,Male,16506,1339,6840,2997,1174,3115,1041,4156,5330,41.9941379,-80.0407591
01/01/2011 12:00:00 AM,42115,Northeast,Northern Tier WDA,Susquehanna,58,45 to 64 Years,Male,6950,682,3262,1206,549,710,541,1251,1800,41.8205686,-75.802503
01/01/2010 12:00:00 AM,42115,Northeast,Northern Tier WDA,Susquehanna,58,45 to 64 Years,Male,6878,671,3269,1158,558,694,528,1222,1780,41.8205686,-75.802503
01/01/2010 12:00:00 AM,42115,Northeast,Northern Tier WDA,Susquehanna,58,45 to 64 Years,Female,6652,520,3106,1182,714,617,513,1130,1844,41.8205686,-75.802503
01/01/2015 12:00:00 AM,42115,Northeast,Northern Tier WDA,Susquehanna,58,45 to 64 Years,Female,6756,508,2969,1275,777,741,486,1227,2004,41.8205686,-75.802503
01/01/2016 12:00:00 AM,42115,Northeast,Northern Tier WDA,Susquehanna,58,45 to 64 Years,Female,6668,494,2991,1311,719,671,482,1153,1872,41.8205686,-75.802503
01/01/2012 12:00:00 AM,42115,Northeast,Northern Tier WDA,Susquehanna,58,45 to 64 Years,Male,6994,698,3308,1254,592,682,460,1142,1734,41.8205686,-75.802503
01/01/2013 12:00:00 AM,42115,Northeast,Northern Tier WDA,Susquehanna,58,45 to 64 Years,Male,7011,652,3431,1193,600,683,452,1135,1735,41.8205686,-75.802503
01/01/2011 12:00:00 AM,42115,Northeast,Northern Tier WDA,Susquehanna,58,45 to 64 Years,Female,6752,531,3060,1223,781,709,448,1157,1938,41.8205686,-75.802503
01/01/2012 12:00:00 AM,42115,Northeast,Northern Tier WDA,Susquehanna,58,45 to 64 Years,Female,6801,518,3138,1242,789,668,446,1114,1903,41.8205686,-75.802503
01/01/2013 12:00:00 AM,42115,Northeast,Northern Tier WDA,Susquehanna,58,45 to 64 Years,Female,6806,508,3150,1242,789,673,444,1117,1906,41.8205686,-75.802503
01/01/2014 12:00:00 AM,42115,Northeast,Northern Tier WDA,Susquehanna,58,45 to 64 Years,Male,6956,673,3470,1172,542,673,426,1099,1641,41.8205686,-75.802503
01/01/2014 12:00:00 AM,42115,Northeast,Northern Tier WDA,Susquehanna,58,45 to 64 Years,Female,6801,471,3133,1297,740,741,419,1160,1900,41.8205686,-75.802503
01/01/2015 12:00:00 AM,42115,Northeast,Northern Tier WDA,Susquehanna,58,45 to 64 Years,Male,6898,741,3558,1161,499,628,311,939,1438,41.8205686,-75.802503
01/01/2016 12:00:00 AM,42115,Northeast,Northern Tier WDA,Susquehanna,58,45 to 64 Years,Male,6774,773,3531,1081,497,591,301,892,1389,41.8205686,-75.802503
01/01/2012 12:00:00 AM,42115,Northeast,Northern Tier WDA,Susquehanna,58,35 to 44 Years,Female,2572,160,1121,446,275,376,194,570,845,41.8205686,-75.802503
01/01/2016 12:00:00 AM,42115,Northeast,Northern Tier WDA,Susquehanna,58,35 to 44 Years,Female,2184,122,893,400,282,296,191,487,769,41.8205686,-75.802503
01/01/2015 12:00:00 AM,42115,Northeast,Northern Tier WDA,Susquehanna,58,35 to 44 Years,Female,2280,127,953,407,282,322,189,511,793,41.8205686,-75.802503
01/01/2011 12:00:00 AM,42115,Northeast,Northern Tier WDA,Susquehanna,58,35 to 44 Years,Female,2664,129,1183,519,322,331,180,511,833,41.8205686,-75.802503
01/01/2013 12:00:00 AM,42115,Northeast,Northern Tier WDA,Susquehanna,58,35 to 44 Years,Female,2454,169,1085,385,279,364,172,536,815,41.8205686,-75.802503
01/01/2010 12:00:00 AM,42115,Northeast,Northern Tier WDA,Susquehanna,58,35 to 44 Years,Female,2730,153,1232,525,327,321,172,493,820,41.8205686,-75.802503
01/01/2014 12:00:00 AM,42115,Northeast,Northern Tier WDA,Susquehanna,58,35 to 44 Years,Female,2358,148,1019,405,278,349,159,508,786,41.8205686,-75.802503
01/01/2015 12:00:00 AM,42115,Northeast,Northern Tier WDA,Susquehanna,58,25 to 34 Years,Female,2063,141,687,421,249,408,157,565,814,41.8205686,-75.802503
01/01/2014 12:00:00 AM,42115,Northeast,Northern Tier WDA,Susquehanna,58,25 to 34 Years,Female,2094,168,727,428,228,393,150,543,771,41.8205686,-75.802503
01/01/2011 12:00:00 AM,42115,Northeast,Northern Tier WDA,Susquehanna,58,25 to 34 Years,Female,2040,173,777,464,165,314,147,461,626,41.8205686,-75.802503
01/01/2016 12:00:00 AM,42115,Northeast,Northern Tier WDA,Susquehanna,58,25 to 34 Years,Female,2043,157,632,430,265,414,145,559,824,41.8205686,-75.802503
01/01/2013 12:00:00 AM,42115,Northeast,Northern Tier WDA,Susquehanna,58,25 to 34 Years,Female,2067,157,782,426,195,367,140,507,702,41.8205686,-75.802503
01/01/2012 12:00:00 AM,42115,Northeast,Northern Tier WDA,Susquehanna,58,25 to 34 Years,Female,2055,196,719,478,161,364,137,501,662,41.8205686,-75.802503
01/01/2015 12:00:00 AM,42115,Northeast,Northern Tier WDA,Susquehanna,58,35 to 44 Years,Male,2389,293,1177,420,208,174,117,291,499,41.8205686,-75.802503
01/01/2010 12:00:00 AM,42115,Northeast,Northern Tier WDA,Susquehanna,58,25 to 34 Years,Female,2016,207,760,419,163,355,112,467,630,41.8205686,-75.802503
01/01/2015 12:00:00 AM,42115,Northeast,Northern Tier WDA,Susquehanna,58,25 to 34 Years,Male,2135,260,920,344,171,331,109,440,611,41.8205686,-75.802503
01/01/2016 12:00:00 AM,42115,Northeast,Northern Tier WDA,Susquehanna,58,25 to 34 Years,Male,2178,289,955,358,191,281,104,385,576,41.8205686,-75.802503
01/01/2014 12:00:00 AM,42115,Northeast,Northern Tier WDA,Susquehanna,58,35 to 44 Years,Male,2456,304,1254,420,173,203,102,305,478,41.8205686,-75.802503
01/01/2011 12:00:00 AM,42115,Northeast,Northern Tier WDA,Susquehanna,58,35 to 44 Years,Male,2701,350,1372,451,184,244,100,344,528,41.8205686,-75.802503
01/01/2013 12:00:00 AM,42115,Northeast,Northern Tier WDA,Susquehanna,58,35 to 44 Years,Male,2491,305,1248,421,207,212,98,310,517,41.8205686,-75.802503
01/01/2012 12:00:00 AM,42115,Northeast,Northern Tier WDA,Susquehanna,58,35 to 44 Years,Male,2601,335,1284,481,193,214,94,308,501,41.8205686,-75.802503
01/01/2016 12:00:00 AM,42115,Northeast,Northern Tier WDA,Susquehanna,58,35 to 44 Years,Male,2286,274,1102,409,223,192,86,278,501,41.8205686,-75.802503
01/01/2014 12:00:00 AM,42115,Northeast,Northern Tier WDA,Susquehanna,58,25 to 34 Years,Male,2132,285,963,331,177,294,82,376,553,41.8205686,-75.802503
01/01/2010 12:00:00 AM,42115,Northeast,Northern Tier WDA,Susquehanna,58,35 to 44 Years,Male,2821,447,1357,459,233,247,78,325,558,41.8205686,-75.802503
01/01/2013 12:00:00 AM,42115,Northeast,Northern Tier WDA,Susquehanna,58,25 to 34 Years,Male,2133,250,1037,320,167,298,61,359,526,41.8205686,-75.802503
01/01/2012 12:00:00 AM,42115,Northeast,Northern Tier WDA,Susquehanna,58,25 to 34 Years,Male,2092,244,947,333,219,300,49,349,568,41.8205686,-75.802503
01/01/2011 12:00:00 AM,42115,Northeast,Northern Tier WDA,Susquehanna,58,25 to 34 Years,Male,2054,248,951,334,212,260,49,309,521,41.8205686,-75.802503
01/01/2010 12:00:00 AM,42115,Northeast,Northern Tier WDA,Susquehanna,58,25 to 34 Years,Male,2024,260,966,305,229,227,37,264,493,41.8205686,-75.802503
01/01/2014 12:00:00 AM,42123,Northwest,Northwest WDA,Warren,62,45 to 64 Years,Male,6491,454,3433,968,522,665,449,1114,1636,41.8167524,-79.2785816
01/01/2013 12:00:00 AM,42123,Northwest,Northwest WDA,Warren,62,45 to 64 Years,Male,6462,470,3370,1006,524,676,416,1092,1616,41.8167524,-79.2785816
01/01/2015 12:00:00 AM,42123,Northwest,Northwest WDA,Warren,62,45 to 64 Years,Male,6430,468,3456,889,549,660,408,1068,1617,41.8167524,-79.2785816
01/01/2010 12:00:00 AM,42123,Northwest,Northwest WDA,Warren,62,45 to 64 Years,Female,6454,357,3152,1263,619,657,406,1063,1682,41.8167524,-79.2785816
01/01/2011 12:00:00 AM,42123,Northwest,Northwest WDA,Warren,62,45 to 64 Years,Female,6515,330,3075,1351,630,725,404,1129,1759,41.8167524,-79.2785816
01/01/2016 12:00:00 AM,42123,Northwest,Northwest WDA,Warren,62,45 to 64 Years,Male,6369,455,3322,924,607,671,390,1061,1668,41.8167524,-79.2785816
01/01/2011 12:00:00 AM,42123,Northwest,Northwest WDA,Warren,62,45 to 64 Years,Male,6460,378,3409,1059,525,705,384,1089,1614,41.8167524,-79.2785816
01/01/2015 12:00:00 AM,42123,Northwest,Northwest WDA,Warren,62,45 to 64 Years,Female,6357,309,3140,1077,743,708,380,1088,1831,41.8167524,-79.2785816
01/01/2013 12:00:00 AM,42123,Northwest,Northwest WDA,Warren,62,45 to 64 Years,Female,6472,321,3115,1201,740,719,376,1095,1835,41.8167524,-79.2785816
01/01/2012 12:00:00 AM,42123,Northwest,Northwest WDA,Warren,62,45 to 64 Years,Female,6525,334,3119,1317,696,689,370,1059,1755,41.8167524,-79.2785816
01/01/2010 12:00:00 AM,42123,Northwest,Northwest WDA,Warren,62,45 to 64 Years,Male,6453,474,3323,1036,560,692,368,1060,1620,41.8167524,-79.2785816
01/01/2012 12:00:00 AM,42123,Northwest,Northwest WDA,Warren,62,45 to 64 Years,Male,6472,436,3402,1030,542,700,362,1062,1604,41.8167524,-79.2785816
01/01/2016 12:00:00 AM,42123,Northwest,Northwest WDA,Warren,62,45 to 64 Years,Female,6262,327,3019,965,812,784,355,1139,1951,41.8167524,-79.2785816
01/01/2014 12:00:00 AM,42123,Northwest,Northwest WDA,Warren,62,45 to 64 Years,Female,6401,313,3078,1173,738,753,346,1099,1837,41.8167524,-79.2785816
01/01/2014 12:00:00 AM,42123,Northwest,Northwest WDA,Warren,62,25 to 34 Years,Female,2044,128,594,342,246,477,257,734,980,41.8167524,-79.2785816
01/01/2012 12:00:00 AM,42123,Northwest,Northwest WDA,Warren,62,35 to 44 Years,Female,2499,161,947,441,375,345,230,575,950,41.8167524,-79.2785816
01/01/2013 12:00:00 AM,42123,Northwest,Northwest WDA,Warren,62,25 to 34 Years,Female,2019,135,640,348,246,422,228,650,896,41.8167524,-79.2785816
01/01/2013 12:00:00 AM,42123,Northwest,Northwest WDA,Warren,62,35 to 44 Years,Female,2392,163,889,462,316,336,226,562,878,41.8167524,-79.2785816
01/01/2015 12:00:00 AM,42123,Northwest,Northwest WDA,Warren,62,25 to 34 Years,Female,2024,161,560,386,213,481,223,704,917,41.8167524,-79.2785816
01/01/2014 12:00:00 AM,42123,Northwest,Northwest WDA,Warren,62,35 to 44 Years,Female,2316,138,816,501,295,347,219,566,861,41.8167524,-79.2785816
01/01/2015 12:00:00 AM,42123,Northwest,Northwest WDA,Warren,62,35 to 44 Years,Female,2277,132,798,495,336,312,204,516,852,41.8167524,-79.2785816
01/01/2016 12:00:00 AM,42123,Northwest,Northwest WDA,Warren,62,25 to 34 Years,Female,2029,160,544,393,225,506,201,707,932,41.8167524,-79.2785816
01/01/2016 12:00:00 AM,42123,Northwest,Northwest WDA,Warren,62,35 to 44 Years,Female,2187,103,757,533,318,289,187,476,794,41.8167524,-79.2785816
01/01/2011 12:00:00 AM,42123,Northwest,Northwest WDA,Warren,62,35 to 44 Years,Female,2577,154,1058,464,361,365,175,540,901,41.8167524,-79.2785816
01/01/2010 12:00:00 AM,42123,Northwest,Northwest WDA,Warren,62,35 to 44 Years,Female,2646,168,1157,473,312,371,165,536,848,41.8167524,-79.2785816
01/01/2012 12:00:00 AM,42123,Northwest,Northwest WDA,Warren,62,25 to 34 Years,Female,2023,102,768,321,250,425,157,582,832,41.8167524,-79.2785816
01/01/2012 12:00:00 AM,42123,Northwest,Northwest WDA,Warren,62,35 to 44 Years,Male,2553,229,1215,430,182,350,147,497,679,41.8167524,-79.2785816
01/01/2011 12:00:00 AM,42123,Northwest,Northwest WDA,Warren,62,25 to 34 Years,Female,2013,107,760,324,295,388,139,527,822,41.8167524,-79.2785816
01/01/2015 12:00:00 AM,42123,Northwest,Northwest WDA,Warren,62,35 to 44 Years,Male,2324,176,1003,438,239,335,133,468,707,41.8167524,-79.2785816
01/01/2010 12:00:00 AM,42123,Northwest,Northwest WDA,Warren,62,25 to 34 Years,Female,2025,98,750,353,311,384,129,513,824,41.8167524,-79.2785816
01/01/2013 12:00:00 AM,42123,Northwest,Northwest WDA,Warren,62,25 to 34 Years,Male,2175,247,766,356,283,400,123,523,806,41.8167524,-79.2785816
01/01/2013 12:00:00 AM,42123,Northwest,Northwest WDA,Warren,62,35 to 44 Years,Male,2467,226,1180,416,179,345,121,466,645,41.8167524,-79.2785816
01/01/2014 12:00:00 AM,42123,Northwest,Northwest WDA,Warren,62,35 to 44 Years,Male,2413,208,1104,470,176,334,121,455,631,41.8167524,-79.2785816
01/01/2016 12:00:00 AM,42123,Northwest,Northwest WDA,Warren,62,35 to 44 Years,Male,2224,193,886,449,251,328,117,445,696,41.8167524,-79.2785816
01/01/2012 12:00:00 AM,42123,Northwest,Northwest WDA,Warren,62,25 to 34 Years,Male,2167,206,852,388,255,352,114,466,721,41.8167524,-79.2785816
01/01/2015 12:00:00 AM,42123,Northwest,Northwest WDA,Warren,62,25 to 34 Years,Male,2151,222,888,304,252,375,110,485,737,41.8167524,-79.2785816
01/01/2011 12:00:00 AM,42123,Northwest,Northwest WDA,Warren,62,25 to 34 Years,Male,2157,231,826,412,244,335,109,444,688,41.8167524,-79.2785816
01/01/2016 12:00:00 AM,42123,Northwest,Northwest WDA,Warren,62,25 to 34 Years,Male,2141,220,863,317,267,368,106,474,741,41.8167524,-79.2785816
01/01/2014 12:00:00 AM,42123,Northwest,Northwest WDA,Warren,62,25 to 34 Years,Male,2160,208,785,331,320,412,104,516,836,41.8167524,-79.2785816
01/01/2010 12:00:00 AM,42123,Northwest,Northwest WDA,Warren,62,25 to 34 Years,Male,2067,186,806,389,272,311,103,414,686,41.8167524,-79.2785816
01/01/2011 12:00:00 AM,42123,Northwest,Northwest WDA,Warren,62,35 to 44 Years,Male,2625,222,1362,411,192,344,94,438,630,41.8167524,-79.2785816
01/01/2010 12:00:00 AM,42123,Northwest,Northwest WDA,Warren,62,35 to 44 Years,Male,2658,242,1254,417,192,461,92,553,745,41.8167524,-79.2785816
01/01/2016 12:00:00 AM,42083,Northwest,North Central WDA,McKean,42,45 to 64 Years,Female,5872,447,2647,972,662,611,533,1144,1806,41.8103707,-78.5712202
01/01/2015 12:00:00 AM,42083,Northwest,North Central WDA,McKean,42,45 to 64 Years,Female,5941,420,2721,1010,675,595,520,1115,1790,41.8103707,-78.5712202
01/01/2014 12:00:00 AM,42083,Northwest,North Central WDA,McKean,42,45 to 64 Years,Female,5971,481,2814,976,676,522,502,1024,1700,41.8103707,-78.5712202
01/01/2012 12:00:00 AM,42083,Northwest,North Central WDA,McKean,42,45 to 64 Years,Female,6030,393,3000,1002,632,505,498,1003,1635,41.8103707,-78.5712202
01/01/2011 12:00:00 AM,42083,Northwest,North Central WDA,McKean,42,45 to 64 Years,Female,5983,382,3027,964,600,516,494,1010,1610,41.8103707,-78.5712202
01/01/2013 12:00:00 AM,42083,Northwest,North Central WDA,McKean,42,45 to 64 Years,Female,6011,406,2976,973,636,532,488,1020,1656,41.8103707,-78.5712202
01/01/2015 12:00:00 AM,42083,Northwest,North Central WDA,McKean,42,45 to 64 Years,Male,6259,529,3108,944,501,732,445,1177,1678,41.8103707,-78.5712202
01/01/2010 12:00:00 AM,42083,Northwest,North Central WDA,McKean,42,45 to 64 Years,Female,5928,349,3188,891,516,566,418,984,1500,41.8103707,-78.5712202
01/01/2011 12:00:00 AM,42083,Northwest,North Central WDA,McKean,42,45 to 64 Years,Male,6337,515,3316,986,415,692,413,1105,1520,41.8103707,-78.5712202
01/01/2012 12:00:00 AM,42083,Northwest,North Central WDA,McKean,42,45 to 64 Years,Male,6317,481,3248,978,449,749,412,1161,1610,41.8103707,-78.5712202
01/01/2013 12:00:00 AM,42083,Northwest,North Central WDA,McKean,42,45 to 64 Years,Male,6305,422,3206,1040,465,764,408,1172,1637,41.8103707,-78.5712202
01/01/2016 12:00:00 AM,42083,Northwest,North Central WDA,McKean,42,45 to 64 Years,Male,6223,527,3219,958,483,663,373,1036,1519,41.8103707,-78.5712202
01/01/2010 12:00:00 AM,42083,Northwest,North Central WDA,McKean,42,45 to 64 Years,Male,6303,536,3250,1008,385,756,368,1124,1509,41.8103707,-78.5712202
01/01/2014 12:00:00 AM,42083,Northwest,North Central WDA,McKean,42,45 to 64 Years,Male,6324,431,3320,973,535,700,365,1065,1600,41.8103707,-78.5712202
01/01/2015 12:00:00 AM,42083,Northwest,North Central WDA,McKean,42,35 to 44 Years,Female,2502,206,791,615,304,319,267,586,890,41.8103707,-78.5712202
01/01/2014 12:00:00 AM,42083,Northwest,North Central WDA,McKean,42,35 to 44 Years,Female,2531,209,815,629,303,313,262,575,878,41.8103707,-78.5712202
01/01/2016 12:00:00 AM,42083,Northwest,North Central WDA,McKean,42,35 to 44 Years,Female,2438,219,850,555,275,321,218,539,814,41.8103707,-78.5712202
01/01/2012 12:00:00 AM,42083,Northwest,North Central WDA,McKean,42,35 to 44 Years,Female,2619,177,1001,607,327,302,205,507,834,41.8103707,-78.5712202
01/01/2013 12:00:00 AM,42083,Northwest,North Central WDA,McKean,42,35 to 44 Years,Female,2567,198,956,548,358,306,201,507,865,41.8103707,-78.5712202
01/01/2011 12:00:00 AM,42083,Northwest,North Central WDA,McKean,42,35 to 44 Years,Female,2699,214,1065,559,362,305,194,499,861,41.8103707,-78.5712202
01/01/2010 12:00:00 AM,42083,Northwest,North Central WDA,McKean,42,35 to 44 Years,Female,2774,233,1105,496,339,410,191,601,940,41.8103707,-78.5712202
01/01/2010 12:00:00 AM,42083,Northwest,North Central WDA,McKean,42,25 to 34 Years,Female,2166,183,835,350,168,446,184,630,798,41.8103707,-78.5712202
01/01/2014 12:00:00 AM,42083,Northwest,North Central WDA,McKean,42,25 to 34 Years,Female,2143,247,721,439,166,398,172,570,736,41.8103707,-78.5712202
01/01/2011 12:00:00 AM,42083,Northwest,North Central WDA,McKean,42,25 to 34 Years,Female,2144,179,729,444,174,448,170,618,792,41.8103707,-78.5712202
01/01/2013 12:00:00 AM,42083,Northwest,North Central WDA,McKean,42,25 to 34 Years,Female,2135,281,688,459,171,367,169,536,707,41.8103707,-78.5712202
01/01/2010 12:00:00 AM,42083,Northwest,North Central WDA,McKean,42,35 to 44 Years,Male,3240,348,1660,571,263,249,149,398,661,41.8103707,-78.5712202
01/01/2011 12:00:00 AM,42083,Northwest,North Central WDA,McKean,42,35 to 44 Years,Male,3199,358,1604,629,244,221,143,364,608,41.8103707,-78.5712202
01/01/2012 12:00:00 AM,42083,Northwest,North Central WDA,McKean,42,35 to 44 Years,Male,3140,342,1550,643,268,194,143,337,605,41.8103707,-78.5712202
01/01/2016 12:00:00 AM,42083,Northwest,North Central WDA,McKean,42,25 to 34 Years,Female,2130,195,798,422,168,405,142,547,715,41.8103707,-78.5712202
01/01/2012 12:00:00 AM,42083,Northwest,North Central WDA,McKean,42,25 to 34 Years,Female,2126,227,724,459,175,399,142,541,716,41.8103707,-78.5712202
01/01/2015 12:00:00 AM,42083,Northwest,North Central WDA,McKean,42,25 to 34 Years,Female,2159,203,793,478,171,375,139,514,685,41.8103707,-78.5712202
01/01/2013 12:00:00 AM,42083,Northwest,North Central WDA,McKean,42,35 to 44 Years,Male,3113,320,1605,550,255,249,134,383,638,41.8103707,-78.5712202
01/01/2014 12:00:00 AM,42083,Northwest,North Central WDA,McKean,42,35 to 44 Years,Male,3125,267,1579,624,283,240,132,372,655,41.8103707,-78.5712202
01/01/2015 12:00:00 AM,42083,Northwest,North Central WDA,McKean,42,35 to 44 Years,Male,3096,213,1632,571,276,285,119,404,680,41.8103707,-78.5712202
01/01/2016 12:00:00 AM,42083,Northwest,North Central WDA,McKean,42,35 to 44 Years,Male,3057,303,1528,564,251,303,108,411,662,41.8103707,-78.5712202
01/01/2016 12:00:00 AM,42083,Northwest,North Central WDA,McKean,42,25 to 34 Years,Male,2696,221,1293,551,260,286,85,371,631,41.8103707,-78.5712202
01/01/2010 12:00:00 AM,42083,Northwest,North Central WDA,McKean,42,25 to 34 Years,Male,2713,261,1278,545,250,302,77,379,629,41.8103707,-78.5712202
01/01/2014 12:00:00 AM,42083,Northwest,North Central WDA,McKean,42,25 to 34 Years,Male,2633,312,1215,543,228,258,77,335,563,41.8103707,-78.5712202
01/01/2011 12:00:00 AM,42083,Northwest,North Central WDA,McKean,42,25 to 34 Years,Male,2644,319,1183,591,204,276,71,347,551,41.8103707,-78.5712202
01/01/2012 12:00:00 AM,42083,Northwest,North Central WDA,McKean,42,25 to 34 Years,Male,2634,339,1164,589,238,244,60,304,542,41.8103707,-78.5712202
01/01/2013 12:00:00 AM,42083,Northwest,North Central WDA,McKean,42,25 to 34 Years,Male,2730,299,1187,696,285,205,58,263,548,41.8103707,-78.5712202
01/01/2015 12:00:00 AM,42083,Northwest,North Central WDA,McKean,42,25 to 34 Years,Male,2638,295,1276,532,203,278,54,332,535,41.8103707,-78.5712202
01/01/2014 12:00:00 AM,42015,Northeast,Northern Tier WDA,Bradford,8,45 to 64 Years,Female,9470,864,4491,1392,956,1048,719,1767,2723,41.7911781,-76.5182562
01/01/2011 12:00:00 AM,42015,Northeast,Northern Tier WDA,Bradford,8,45 to 64 Years,Female,9333,961,4332,1452,816,1062,710,1772,2588,41.7911781,-76.5182562
01/01/2013 12:00:00 AM,42015,Northeast,Northern Tier WDA,Bradford,8,45 to 64 Years,Female,9499,904,4386,1430,936,1149,694,1843,2779,41.7911781,-76.5182562
01/01/2015 12:00:00 AM,42015,Northeast,Northern Tier WDA,Bradford,8,45 to 64 Years,Female,9426,838,4448,1349,1011,1103,677,1780,2791,41.7911781,-76.5182562
01/01/2012 12:00:00 AM,42015,Northeast,Northern Tier WDA,Bradford,8,45 to 64 Years,Female,9375,954,4361,1396,928,1061,675,1736,2664,41.7911781,-76.5182562
01/01/2010 12:00:00 AM,42015,Northeast,Northern Tier WDA,Bradford,8,45 to 64 Years,Female,9208,913,4401,1446,814,999,635,1634,2448,41.7911781,-76.5182562
01/01/2016 12:00:00 AM,42015,Northeast,Northern Tier WDA,Bradford,8,45 to 64 Years,Female,9258,760,4386,1436,1037,1060,579,1639,2676,41.7911781,-76.5182562
01/01/2015 12:00:00 AM,42015,Northeast,Northern Tier WDA,Bradford,8,45 to 64 Years,Male,9186,1000,4608,1284,780,952,562,1514,2294,41.7911781,-76.5182562
01/01/2016 12:00:00 AM,42015,Northeast,Northern Tier WDA,Bradford,8,45 to 64 Years,Male,9125,1010,4776,1206,739,876,518,1394,2133,41.7911781,-76.5182562
01/01/2011 12:00:00 AM,42015,Northeast,Northern Tier WDA,Bradford,8,45 to 64 Years,Male,9223,1136,4593,1280,767,938,509,1447,2214,41.7911781,-76.5182562
01/01/2012 12:00:00 AM,42015,Northeast,Northern Tier WDA,Bradford,8,45 to 64 Years,Male,9281,1063,4689,1297,815,913,504,1417,2232,41.7911781,-76.5182562
01/01/2014 12:00:00 AM,42015,Northeast,Northern Tier WDA,Bradford,8,45 to 64 Years,Male,9251,1022,4618,1356,824,936,495,1431,2255,41.7911781,-76.5182562
01/01/2013 12:00:00 AM,42015,Northeast,Northern Tier WDA,Bradford,8,45 to 64 Years,Male,9248,955,4783,1290,815,915,490,1405,2220,41.7911781,-76.5182562
01/01/2010 12:00:00 AM,42015,Northeast,Northern Tier WDA,Bradford,8,45 to 64 Years,Male,9076,1127,4646,1271,672,891,469,1360,2032,41.7911781,-76.5182562
01/01/2010 12:00:00 AM,42015,Northeast,Northern Tier WDA,Bradford,8,35 to 44 Years,Female,4120,343,1753,672,491,601,260,861,1352,41.7911781,-76.5182562
01/01/2014 12:00:00 AM,42015,Northeast,Northern Tier WDA,Bradford,8,25 to 34 Years,Female,3263,245,1186,474,428,687,243,930,1358,41.7911781,-76.5182562
01/01/2016 12:00:00 AM,42015,Northeast,Northern Tier WDA,Bradford,8,35 to 44 Years,Female,3364,221,1427,513,350,611,242,853,1203,41.7911781,-76.5182562
01/01/2012 12:00:00 AM,42015,Northeast,Northern Tier WDA,Bradford,8,25 to 34 Years,Female,3202,251,1190,529,444,550,238,788,1232,41.7911781,-76.5182562
01/01/2013 12:00:00 AM,42015,Northeast,Northern Tier WDA,Bradford,8,35 to 44 Years,Female,3712,285,1407,684,434,666,236,902,1336,41.7911781,-76.5182562
01/01/2015 12:00:00 AM,42015,Northeast,Northern Tier WDA,Bradford,8,35 to 44 Years,Female,3458,218,1392,652,414,557,225,782,1196,41.7911781,-76.5182562
01/01/2013 12:00:00 AM,42015,Northeast,Northern Tier WDA,Bradford,8,25 to 34 Years,Female,3221,242,1136,519,435,665,224,889,1324,41.7911781,-76.5182562
01/01/2013 12:00:00 AM,42015,Northeast,Northern Tier WDA,Bradford,8,35 to 44 Years,Male,3679,455,1764,621,274,341,224,565,839,41.7911781,-76.5182562
01/01/2011 12:00:00 AM,42015,Northeast,Northern Tier WDA,Bradford,8,25 to 34 Years,Female,3165,299,1124,572,438,513,219,732,1170,41.7911781,-76.5182562
01/01/2015 12:00:00 AM,42015,Northeast,Northern Tier WDA,Bradford,8,25 to 34 Years,Female,3267,330,1127,509,363,725,213,938,1301,41.7911781,-76.5182562
01/01/2011 12:00:00 AM,42015,Northeast,Northern Tier WDA,Bradford,8,35 to 44 Years,Female,4002,365,1696,658,422,652,209,861,1283,41.7911781,-76.5182562
01/01/2014 12:00:00 AM,42015,Northeast,Northern Tier WDA,Bradford,8,35 to 44 Years,Female,3577,239,1479,706,425,522,206,728,1153,41.7911781,-76.5182562
01/01/2012 12:00:00 AM,42015,Northeast,Northern Tier WDA,Bradford,8,35 to 44 Years,Female,3917,322,1653,688,406,648,200,848,1254,41.7911781,-76.5182562
01/01/2014 12:00:00 AM,42015,Northeast,Northern Tier WDA,Bradford,8,35 to 44 Years,Male,3562,396,1866,529,278,306,187,493,771,41.7911781,-76.5182562
01/01/2016 12:00:00 AM,42015,Northeast,Northern Tier WDA,Bradford,8,25 to 34 Years,Female,3247,294,1035,600,383,751,184,935,1318,41.7911781,-76.5182562
01/01/2010 12:00:00 AM,42015,Northeast,Northern Tier WDA,Bradford,8,35 to 44 Years,Male,4101,580,2080,560,249,448,184,632,881,41.7911781,-76.5182562
01/01/2012 12:00:00 AM,42015,Northeast,Northern Tier WDA,Bradford,8,35 to 44 Years,Male,3804,483,1882,609,245,401,184,585,830,41.7911781,-76.5182562
01/01/2011 12:00:00 AM,42015,Northeast,Northern Tier WDA,Bradford,8,35 to 44 Years,Male,3908,561,1943,603,211,419,171,590,801,41.7911781,-76.5182562
01/01/2010 12:00:00 AM,42015,Northeast,Northern Tier WDA,Bradford,8,25 to 34 Years,Female,3146,244,1144,614,479,495,170,665,1144,41.7911781,-76.5182562
01/01/2015 12:00:00 AM,42015,Northeast,Northern Tier WDA,Bradford,8,35 to 44 Years,Male,3428,389,1702,518,299,360,160,520,819,41.7911781,-76.5182562
01/01/2016 12:00:00 AM,42015,Northeast,Northern Tier WDA,Bradford,8,35 to 44 Years,Male,3375,372,1653,460,324,413,153,566,890,41.7911781,-76.5182562
01/01/2016 12:00:00 AM,42015,Northeast,Northern Tier WDA,Bradford,8,25 to 34 Years,Male,3292,343,1680,410,354,419,86,505,859,41.7911781,-76.5182562
01/01/2015 12:00:00 AM,42015,Northeast,Northern Tier WDA,Bradford,8,25 to 34 Years,Male,3324,364,1784,415,268,432,61,493,761,41.7911781,-76.5182562
01/01/2014 12:00:00 AM,42015,Northeast,Northern Tier WDA,Bradford,8,25 to 34 Years,Male,3241,410,1683,399,243,454,52,506,749,41.7911781,-76.5182562
01/01/2012 12:00:00 AM,42015,Northeast,Northern Tier WDA,Bradford,8,25 to 34 Years,Male,3121,303,1496,501,265,506,50,556,821,41.7911781,-76.5182562
01/01/2013 12:00:00 AM,42015,Northeast,Northern Tier WDA,Bradford,8,25 to 34 Years,Male,3208,340,1723,388,234,479,44,523,757,41.7911781,-76.5182562
01/01/2010 12:00:00 AM,42015,Northeast,Northern Tier WDA,Bradford,8,25 to 34 Years,Male,3002,388,1418,423,240,494,39,533,773,41.7911781,-76.5182562
01/01/2011 12:00:00 AM,42015,Northeast,Northern Tier WDA,Bradford,8,25 to 34 Years,Male,3055,345,1509,459,238,474,30,504,742,41.7911781,-76.5182562
01/01/2010 12:00:00 AM,42117,Northeast,Northern Tier WDA,Tioga,59,45 to 64 Years,Female,5965,436,2540,1195,628,612,554,1166,1794,41.7733383,-77.2578808
01/01/2014 12:00:00 AM,42117,Northeast,Northern Tier WDA,Tioga,59,45 to 64 Years,Female,6084,473,2641,1013,749,668,540,1208,1957,41.7733383,-77.2578808
01/01/2016 12:00:00 AM,42117,Northeast,Northern Tier WDA,Tioga,59,45 to 64 Years,Female,6001,443,2545,938,751,791,533,1324,2075,41.7733383,-77.2578808
01/01/2015 12:00:00 AM,42117,Northeast,Northern Tier WDA,Tioga,59,45 to 64 Years,Female,6047,452,2737,945,658,723,532,1255,1913,41.7733383,-77.2578808
01/01/2011 12:00:00 AM,42117,Northeast,Northern Tier WDA,Tioga,59,45 to 64 Years,Female,6033,487,2595,1159,660,603,529,1132,1792,41.7733383,-77.2578808
01/01/2012 12:00:00 AM,42117,Northeast,Northern Tier WDA,Tioga,59,45 to 64 Years,Female,6050,463,2611,1143,678,635,520,1155,1833,41.7733383,-77.2578808
01/01/2013 12:00:00 AM,42117,Northeast,Northern Tier WDA,Tioga,59,45 to 64 Years,Female,6088,493,2632,1079,709,693,482,1175,1884,41.7733383,-77.2578808
01/01/2012 12:00:00 AM,42117,Northeast,Northern Tier WDA,Tioga,59,45 to 64 Years,Male,5990,651,2934,937,459,588,421,1009,1468,41.7733383,-77.2578808
01/01/2011 12:00:00 AM,42117,Northeast,Northern Tier WDA,Tioga,59,45 to 64 Years,Male,5933,674,2850,904,470,623,412,1035,1505,41.7733383,-77.2578808
01/01/2010 12:00:00 AM,42117,Northeast,Northern Tier WDA,Tioga,59,45 to 64 Years,Male,5863,687,2761,860,487,668,400,1068,1555,41.7733383,-77.2578808
01/01/2013 12:00:00 AM,42117,Northeast,Northern Tier WDA,Tioga,59,45 to 64 Years,Male,6002,677,2891,992,469,575,398,973,1442,41.7733383,-77.2578808
01/01/2014 12:00:00 AM,42117,Northeast,Northern Tier WDA,Tioga,59,45 to 64 Years,Male,5984,667,2843,1058,467,562,387,949,1416,41.7733383,-77.2578808
01/01/2015 12:00:00 AM,42117,Northeast,Northern Tier WDA,Tioga,59,45 to 64 Years,Male,5988,672,2942,968,451,578,377,955,1406,41.7733383,-77.2578808
01/01/2016 12:00:00 AM,42117,Northeast,Northern Tier WDA,Tioga,59,45 to 64 Years,Male,5911,640,2807,987,506,603,368,971,1477,41.7733383,-77.2578808
01/01/2016 12:00:00 AM,42117,Northeast,Northern Tier WDA,Tioga,59,35 to 44 Years,Female,2215,62,840,383,262,417,251,668,930,41.7733383,-77.2578808
01/01/2015 12:00:00 AM,42117,Northeast,Northern Tier WDA,Tioga,59,35 to 44 Years,Female,2252,46,805,455,268,428,250,678,946,41.7733383,-77.2578808
01/01/2014 12:00:00 AM,42117,Northeast,Northern Tier WDA,Tioga,59,35 to 44 Years,Female,2309,56,815,508,306,384,240,624,930,41.7733383,-77.2578808
01/01/2016 12:00:00 AM,42117,Northeast,Northern Tier WDA,Tioga,59,25 to 34 Years,Female,2272,201,608,470,205,557,231,788,993,41.7733383,-77.2578808
01/01/2013 12:00:00 AM,42117,Northeast,Northern Tier WDA,Tioga,59,25 to 34 Years,Female,2156,177,492,528,175,554,230,784,959,41.7733383,-77.2578808
01/01/2015 12:00:00 AM,42117,Northeast,Northern Tier WDA,Tioga,59,25 to 34 Years,Female,2244,214,559,497,206,542,226,768,974,41.7733383,-77.2578808
01/01/2014 12:00:00 AM,42117,Northeast,Northern Tier WDA,Tioga,59,25 to 34 Years,Female,2194,176,502,502,225,566,223,789,1014,41.7733383,-77.2578808
01/01/2013 12:00:00 AM,42117,Northeast,Northern Tier WDA,Tioga,59,35 to 44 Years,Female,2359,58,807,593,306,392,203,595,901,41.7733383,-77.2578808
01/01/2011 12:00:00 AM,42117,Northeast,Northern Tier WDA,Tioga,59,35 to 44 Years,Female,2535,101,825,637,450,332,190,522,972,41.7733383,-77.2578808
01/01/2010 12:00:00 AM,42117,Northeast,Northern Tier WDA,Tioga,59,35 to 44 Years,Female,2597,129,949,602,430,304,183,487,917,41.7733383,-77.2578808
01/01/2012 12:00:00 AM,42117,Northeast,Northern Tier WDA,Tioga,59,25 to 34 Years,Female,2082,159,527,530,166,531,169,700,866,41.7733383,-77.2578808
01/01/2012 12:00:00 AM,42117,Northeast,Northern Tier WDA,Tioga,59,35 to 44 Years,Female,2446,96,829,588,412,359,162,521,933,41.7733383,-77.2578808
01/01/2015 12:00:00 AM,42117,Northeast,Northern Tier WDA,Tioga,59,25 to 34 Years,Male,2371,296,877,429,225,393,151,544,769,41.7733383,-77.2578808
01/01/2014 12:00:00 AM,42117,Northeast,Northern Tier WDA,Tioga,59,35 to 44 Years,Male,2355,166,1137,486,179,239,148,387,566,41.7733383,-77.2578808
01/01/2010 12:00:00 AM,42117,Northeast,Northern Tier WDA,Tioga,59,35 to 44 Years,Male,2484,226,1152,495,197,267,147,414,611,41.7733383,-77.2578808
01/01/2011 12:00:00 AM,42117,Northeast,Northern Tier WDA,Tioga,59,35 to 44 Years,Male,2456,235,1129,502,214,230,146,376,590,41.7733383,-77.2578808
01/01/2016 12:00:00 AM,42117,Northeast,Northern Tier WDA,Tioga,59,35 to 44 Years,Male,2264,181,1035,457,171,278,142,420,591,41.7733383,-77.2578808
01/01/2015 12:00:00 AM,42117,Northeast,Northern Tier WDA,Tioga,59,35 to 44 Years,Male,2354,170,1142,489,173,241,139,380,553,41.7733383,-77.2578808
01/01/2013 12:00:00 AM,42117,Northeast,Northern Tier WDA,Tioga,59,35 to 44 Years,Male,2376,198,1151,475,189,232,131,363,552,41.7733383,-77.2578808
01/01/2011 12:00:00 AM,42117,Northeast,Northern Tier WDA,Tioga,59,25 to 34 Years,Female,2012,204,556,435,252,436,129,565,817,41.7733383,-77.2578808
01/01/2014 12:00:00 AM,42117,Northeast,Northern Tier WDA,Tioga,59,25 to 34 Years,Male,2356,262,893,459,218,396,128,524,742,41.7733383,-77.2578808
01/01/2016 12:00:00 AM,42117,Northeast,Northern Tier WDA,Tioga,59,25 to 34 Years,Male,2436,251,1050,413,210,385,127,512,722,41.7733383,-77.2578808
01/01/2010 12:00:00 AM,42117,Northeast,Northern Tier WDA,Tioga,59,25 to 34 Years,Female,2008,214,494,483,247,456,114,570,817,41.7733383,-77.2578808
01/01/2012 12:00:00 AM,42117,Northeast,Northern Tier WDA,Tioga,59,35 to 44 Years,Male,2403,231,1183,475,203,198,113,311,514,41.7733383,-77.2578808
01/01/2013 12:00:00 AM,42117,Northeast,Northern Tier WDA,Tioga,59,25 to 34 Years,Male,2250,219,916,446,222,336,111,447,669,41.7733383,-77.2578808
01/01/2011 12:00:00 AM,42117,Northeast,Northern Tier WDA,Tioga,59,25 to 34 Years,Male,2115,223,916,461,170,250,95,345,515,41.7733383,-77.2578808
01/01/2010 12:00:00 AM,42117,Northeast,Northern Tier WDA,Tioga,59,25 to 34 Years,Male,2065,194,925,414,172,284,76,360,532,41.7733383,-77.2578808
01/01/2012 12:00:00 AM,42117,Northeast,Northern Tier WDA,Tioga,59,25 to 34 Years,Male,2177,260,918,442,181,313,63,376,557,41.7733383,-77.2578808
01/01/2012 12:00:00 AM,42105,Northwest,North Central WDA,Potter,53,45 to 64 Years,Male,2633,276,1421,372,180,206,178,384,564,41.7442064,-77.8987923
01/01/2014 12:00:00 AM,42105,Northwest,North Central WDA,Potter,53,45 to 64 Years,Male,2615,254,1374,398,141,271,177,448,589,41.7442064,-77.8987923
01/01/2015 12:00:00 AM,42105,Northwest,North Central WDA,Potter,53,45 to 64 Years,Female,2595,240,1278,484,251,172,170,342,593,41.7442064,-77.8987923
01/01/2014 12:00:00 AM,42105,Northwest,North Central WDA,Potter,53,45 to 64 Years,Female,2623,219,1345,456,245,190,168,358,603,41.7442064,-77.8987923
01/01/2013 12:00:00 AM,42105,Northwest,North Central WDA,Potter,53,45 to 64 Years,Male,2613,227,1420,372,157,273,164,437,594,41.7442064,-77.8987923
01/01/2016 12:00:00 AM,42105,Northwest,North Central WDA,Potter,53,45 to 64 Years,Male,2565,254,1366,402,155,236,152,388,543,41.7442064,-77.8987923
01/01/2015 12:00:00 AM,42105,Northwest,North Central WDA,Potter,53,45 to 64 Years,Male,2593,262,1351,393,160,276,151,427,587,41.7442064,-77.8987923
01/01/2016 12:00:00 AM,42105,Northwest,North Central WDA,Potter,53,45 to 64 Years,Female,2551,254,1224,492,264,177,140,317,581,41.7442064,-77.8987923
01/01/2013 12:00:00 AM,42105,Northwest,North Central WDA,Potter,53,45 to 64 Years,Female,2625,221,1349,456,236,225,138,363,599,41.7442064,-77.8987923
01/01/2011 12:00:00 AM,42105,Northwest,North Central WDA,Potter,53,45 to 64 Years,Female,2601,195,1400,392,242,238,134,372,614,41.7442064,-77.8987923
01/01/2012 12:00:00 AM,42105,Northwest,North Central WDA,Potter,53,45 to 64 Years,Female,2612,200,1409,427,234,217,125,342,576,41.7442064,-77.8987923
01/01/2011 12:00:00 AM,42105,Northwest,North Central WDA,Potter,53,45 to 64 Years,Male,2631,273,1420,354,201,262,121,383,584,41.7442064,-77.8987923
01/01/2014 12:00:00 AM,42105,Northwest,North Central WDA,Potter,53,35 to 44 Years,Female,927,39,419,164,82,103,120,223,305,41.7442064,-77.8987923
01/01/2010 12:00:00 AM,42105,Northwest,North Central WDA,Potter,53,45 to 64 Years,Male,2596,284,1334,391,204,265,118,383,587,41.7442064,-77.8987923
01/01/2015 12:00:00 AM,42105,Northwest,North Central WDA,Potter,53,35 to 44 Years,Female,900,12,426,181,66,101,114,215,281,41.7442064,-77.8987923
01/01/2016 12:00:00 AM,42105,Northwest,North Central WDA,Potter,53,35 to 44 Years,Female,874,23,370,175,106,91,109,200,306,41.7442064,-77.8987923
01/01/2013 12:00:00 AM,42105,Northwest,North Central WDA,Potter,53,35 to 44 Years,Female,974,50,450,177,92,101,104,205,297,41.7442064,-77.8987923
01/01/2010 12:00:00 AM,42105,Northwest,North Central WDA,Potter,53,45 to 64 Years,Female,2587,227,1397,380,230,255,98,353,583,41.7442064,-77.8987923
01/01/2012 12:00:00 AM,42105,Northwest,North Central WDA,Potter,53,35 to 44 Years,Female,996,53,461,189,96,101,96,197,293,41.7442064,-77.8987923
01/01/2015 12:00:00 AM,42105,Northwest,North Central WDA,Potter,53,25 to 34 Years,Female,801,43,265,169,92,142,90,232,324,41.7442064,-77.8987923
01/01/2016 12:00:00 AM,42105,Northwest,North Central WDA,Potter,53,25 to 34 Years,Female,797,58,266,188,77,130,78,208,285,41.7442064,-77.8987923
01/01/2013 12:00:00 AM,42105,Northwest,North Central WDA,Potter,53,35 to 44 Years,Male,971,46,512,146,87,104,76,180,267,41.7442064,-77.8987923
01/01/2014 12:00:00 AM,42105,Northwest,North Central WDA,Potter,53,25 to 34 Years,Female,802,42,310,186,76,118,70,188,264,41.7442064,-77.8987923
01/01/2013 12:00:00 AM,42105,Northwest,North Central WDA,Potter,53,25 to 34 Years,Female,795,47,311,189,90,94,64,158,248,41.7442064,-77.8987923
01/01/2014 12:00:00 AM,42105,Northwest,North Central WDA,Potter,53,35 to 44 Years,Male,933,32,507,170,69,93,62,155,224,41.7442064,-77.8987923
01/01/2012 12:00:00 AM,42105,Northwest,North Central WDA,Potter,53,25 to 34 Years,Female,801,54,318,192,100,76,61,137,237,41.7442064,-77.8987923
01/01/2011 12:00:00 AM,42105,Northwest,North Central WDA,Potter,53,35 to 44 Years,Female,1030,64,509,193,110,95,59,154,264,41.7442064,-77.8987923
01/01/2012 12:00:00 AM,42105,Northwest,North Central WDA,Potter,53,25 to 34 Years,Male,844,68,356,174,104,83,59,142,246,41.7442064,-77.8987923
01/01/2016 12:00:00 AM,42105,Northwest,North Central WDA,Potter,53,35 to 44 Years,Male,899,27,459,183,93,84,53,137,230,41.7442064,-77.8987923
01/01/2010 12:00:00 AM,42105,Northwest,North Central WDA,Potter,53,35 to 44 Years,Female,1092,124,515,185,131,85,52,137,268,41.7442064,-77.8987923
01/01/2010 12:00:00 AM,42105,Northwest,North Central WDA,Potter,53,25 to 34 Years,Male,850,79,375,132,141,71,52,123,264,41.7442064,-77.8987923
01/01/2012 12:00:00 AM,42105,Northwest,North Central WDA,Potter,53,35 to 44 Years,Male,1003,40,565,147,82,119,50,169,251,41.7442064,-77.8987923
01/01/2011 12:00:00 AM,42105,Northwest,North Central WDA,Potter,53,25 to 34 Years,Male,850,68,346,163,140,83,50,133,273,41.7442064,-77.8987923
01/01/2015 12:00:00 AM,42105,Northwest,North Central WDA,Potter,53,35 to 44 Years,Male,909,36,483,191,71,78,50,128,199,41.7442064,-77.8987923
01/01/2011 12:00:00 AM,42105,Northwest,North Central WDA,Potter,53,25 to 34 Years,Female,795,59,307,211,103,65,50,115,218,41.7442064,-77.8987923
01/01/2011 12:00:00 AM,42105,Northwest,North Central WDA,Potter,53,35 to 44 Years,Male,1023,58,550,157,102,111,45,156,258,41.7442064,-77.8987923
01/01/2016 12:00:00 AM,42105,Northwest,North Central WDA,Potter,53,25 to 34 Years,Male,878,71,383,139,118,123,44,167,285,41.7442064,-77.8987923
01/01/2010 12:00:00 AM,42105,Northwest,North Central WDA,Potter,53,25 to 34 Years,Female,810,72,333,206,92,64,43,107,199,41.7442064,-77.8987923
01/01/2010 12:00:00 AM,42105,Northwest,North Central WDA,Potter,53,35 to 44 Years,Male,1056,83,556,148,108,119,42,161,269,41.7442064,-77.8987923
01/01/2014 12:00:00 AM,42105,Northwest,North Central WDA,Potter,53,25 to 34 Years,Male,865,75,383,165,98,105,39,144,242,41.7442064,-77.8987923
01/01/2015 12:00:00 AM,42105,Northwest,North Central WDA,Potter,53,25 to 34 Years,Male,871,69,386,128,115,136,37,173,288,41.7442064,-77.8987923
01/01/2013 12:00:00 AM,42105,Northwest,North Central WDA,Potter,53,25 to 34 Years,Male,849,71,377,197,90,84,30,114,204,41.7442064,-77.8987923
01/01/2016 12:00:00 AM,42039,Northwest,Northwest WDA,Crawford,20,45 to 64 Years,Female,12807,1082,5983,1794,1222,1670,1056,2726,3948,41.6854691,-80.1132108
01/01/2015 12:00:00 AM,42039,Northwest,Northwest WDA,Crawford,20,45 to 64 Years,Female,12908,1179,6104,1846,1173,1641,965,2606,3779,41.6854691,-80.1132108
01/01/2010 12:00:00 AM,42039,Northwest,Northwest WDA,Crawford,20,45 to 64 Years,Female,13004,1274,6510,1873,876,1516,955,2471,3347,41.6854691,-80.1132108
01/01/2014 12:00:00 AM,42039,Northwest,Northwest WDA,Crawford,20,45 to 64 Years,Male,12472,1353,6064,1905,763,1439,948,2387,3150,41.6854691,-80.1132108
01/01/2013 12:00:00 AM,42039,Northwest,Northwest WDA,Crawford,20,45 to 64 Years,Female,13126,1158,6540,1898,1143,1459,928,2387,3530,41.6854691,-80.1132108
01/01/2014 12:00:00 AM,42039,Northwest,Northwest WDA,Crawford,20,45 to 64 Years,Female,12987,1156,6294,1921,1112,1594,910,2504,3616,41.6854691,-80.1132108
01/01/2015 12:00:00 AM,42039,Northwest,Northwest WDA,Crawford,20,45 to 64 Years,Male,12323,1267,6035,1945,763,1413,900,2313,3076,41.6854691,-80.1132108
01/01/2012 12:00:00 AM,42039,Northwest,Northwest WDA,Crawford,20,45 to 64 Years,Female,13129,1179,6607,1903,1075,1482,883,2365,3440,41.6854691,-80.1132108
01/01/2016 12:00:00 AM,42039,Northwest,Northwest WDA,Crawford,20,45 to 64 Years,Male,12159,1230,5936,1956,752,1416,869,2285,3037,41.6854691,-80.1132108
01/01/2013 12:00:00 AM,42039,Northwest,Northwest WDA,Crawford,20,45 to 64 Years,Male,12499,1393,6056,1953,809,1421,867,2288,3097,41.6854691,-80.1132108
01/01/2011 12:00:00 AM,42039,Northwest,Northwest WDA,Crawford,20,45 to 64 Years,Female,13069,1285,6479,1938,949,1556,862,2418,3367,41.6854691,-80.1132108
01/01/2012 12:00:00 AM,42039,Northwest,Northwest WDA,Crawford,20,45 to 64 Years,Male,12468,1394,5929,2075,822,1401,847,2248,3070,41.6854691,-80.1132108
01/01/2011 12:00:00 AM,42039,Northwest,Northwest WDA,Crawford,20,45 to 64 Years,Male,12373,1441,6014,2005,742,1332,839,2171,2913,41.6854691,-80.1132108
01/01/2010 12:00:00 AM,42039,Northwest,Northwest WDA,Crawford,20,45 to 64 Years,Male,12331,1623,5957,1948,689,1316,798,2114,2803,41.6854691,-80.1132108
01/01/2016 12:00:00 AM,42039,Northwest,Northwest WDA,Crawford,20,35 to 44 Years,Female,5084,305,1665,976,680,810,648,1458,2138,41.6854691,-80.1132108
01/01/2015 12:00:00 AM,42039,Northwest,Northwest WDA,Crawford,20,35 to 44 Years,Female,5182,342,1860,966,635,847,532,1379,2014,41.6854691,-80.1132108
01/01/2014 12:00:00 AM,42039,Northwest,Northwest WDA,Crawford,20,35 to 44 Years,Female,5338,342,2003,913,685,870,525,1395,2080,41.6854691,-80.1132108
01/01/2016 12:00:00 AM,42039,Northwest,Northwest WDA,Crawford,20,25 to 34 Years,Female,4746,550,1260,867,454,1121,494,1615,2069,41.6854691,-80.1132108
01/01/2013 12:00:00 AM,42039,Northwest,Northwest WDA,Crawford,20,35 to 44 Years,Female,5429,395,2146,850,654,927,457,1384,2038,41.6854691,-80.1132108
01/01/2015 12:00:00 AM,42039,Northwest,Northwest WDA,Crawford,20,25 to 34 Years,Female,4696,586,1276,909,430,1081,414,1495,1925,41.6854691,-80.1132108
01/01/2014 12:00:00 AM,42039,Northwest,Northwest WDA,Crawford,20,25 to 34 Years,Female,4715,567,1314,901,422,1104,407,1511,1933,41.6854691,-80.1132108
01/01/2010 12:00:00 AM,42039,Northwest,Northwest WDA,Crawford,20,35 to 44 Years,Male,5550,561,2726,863,331,669,400,1069,1400,41.6854691,-80.1132108
01/01/2010 12:00:00 AM,42039,Northwest,Northwest WDA,Crawford,20,35 to 44 Years,Female,5951,551,2406,937,611,1048,398,1446,2057,41.6854691,-80.1132108
01/01/2010 12:00:00 AM,42039,Northwest,Northwest WDA,Crawford,20,25 to 34 Years,Female,4733,617,1485,1016,428,822,365,1187,1615,41.6854691,-80.1132108
01/01/2011 12:00:00 AM,42039,Northwest,Northwest WDA,Crawford,20,25 to 34 Years,Female,4731,626,1457,1003,417,865,363,1228,1645,41.6854691,-80.1132108
01/01/2012 12:00:00 AM,42039,Northwest,Northwest WDA,Crawford,20,35 to 44 Years,Female,5522,444,2176,846,629,1067,360,1427,2056,41.6854691,-80.1132108
01/01/2012 12:00:00 AM,42039,Northwest,Northwest WDA,Crawford,20,25 to 34 Years,Female,4584,642,1199,1017,429,952,345,1297,1726,41.6854691,-80.1132108
01/01/2011 12:00:00 AM,42039,Northwest,Northwest WDA,Crawford,20,35 to 44 Years,Male,5323,584,2593,830,301,675,340,1015,1316,41.6854691,-80.1132108
01/01/2011 12:00:00 AM,42039,Northwest,Northwest WDA,Crawford,20,35 to 44 Years,Female,5751,497,2267,941,632,1075,339,1414,2046,41.6854691,-80.1132108
01/01/2013 12:00:00 AM,42039,Northwest,Northwest WDA,Crawford,20,25 to 34 Years,Female,4588,633,1234,1033,390,978,320,1298,1688,41.6854691,-80.1132108
01/01/2014 12:00:00 AM,42039,Northwest,Northwest WDA,Crawford,20,35 to 44 Years,Male,4857,622,2162,832,331,592,318,910,1241,41.6854691,-80.1132108
01/01/2016 12:00:00 AM,42039,Northwest,Northwest WDA,Crawford,20,25 to 34 Years,Male,4531,687,1767,676,473,618,310,928,1401,41.6854691,-80.1132108
01/01/2013 12:00:00 AM,42039,Northwest,Northwest WDA,Crawford,20,35 to 44 Years,Male,5013,578,2275,937,321,611,291,902,1223,41.6854691,-80.1132108
01/01/2012 12:00:00 AM,42039,Northwest,Northwest WDA,Crawford,20,35 to 44 Years,Male,5148,584,2392,961,318,602,291,893,1211,41.6854691,-80.1132108
01/01/2012 12:00:00 AM,42039,Northwest,Northwest WDA,Crawford,20,25 to 34 Years,Male,4449,729,1642,731,416,656,275,931,1347,41.6854691,-80.1132108
01/01/2016 12:00:00 AM,42039,Northwest,Northwest WDA,Crawford,20,35 to 44 Years,Male,4644,509,2050,861,321,628,275,903,1224,41.6854691,-80.1132108
01/01/2013 12:00:00 AM,42039,Northwest,Northwest WDA,Crawford,20,25 to 34 Years,Male,4496,827,1663,641,474,621,270,891,1365,41.6854691,-80.1132108
01/01/2010 12:00:00 AM,42039,Northwest,Northwest WDA,Crawford,20,25 to 34 Years,Male,4503,619,2073,645,285,617,264,881,1166,41.6854691,-80.1132108
01/01/2011 12:00:00 AM,42039,Northwest,Northwest WDA,Crawford,20,25 to 34 Years,Male,4491,663,1816,719,385,653,255,908,1293,41.6854691,-80.1132108
01/01/2015 12:00:00 AM,42039,Northwest,Northwest WDA,Crawford,20,35 to 44 Years,Male,4764,527,2157,887,316,636,241,877,1193,41.6854691,-80.1132108
01/01/2015 12:00:00 AM,42039,Northwest,Northwest WDA,Crawford,20,25 to 34 Years,Male,4491,783,1590,791,470,625,232,857,1327,41.6854691,-80.1132108
01/01/2014 12:00:00 AM,42039,Northwest,Northwest WDA,Crawford,20,25 to 34 Years,Male,4463,724,1642,706,479,697,215,912,1391,41.6854691,-80.1132108
01/01/2012 12:00:00 AM,42127,Northeast,Pocono Counties WDA,Wayne,64,45 to 64 Years,Male,8713,1145,3710,1534,554,884,886,1770,2324,41.6496981,-75.3051535
01/01/2011 12:00:00 AM,42127,Northeast,Pocono Counties WDA,Wayne,64,45 to 64 Years,Male,8583,1170,3570,1612,512,881,838,1719,2231,41.6496981,-75.3051535
01/01/2013 12:00:00 AM,42127,Northeast,Pocono Counties WDA,Wayne,64,45 to 64 Years,Male,8721,1097,3733,1576,564,915,836,1751,2315,41.6496981,-75.3051535
01/01/2012 12:00:00 AM,42127,Northeast,Pocono Counties WDA,Wayne,64,45 to 64 Years,Female,7974,547,3434,1471,915,823,784,1607,2522,41.6496981,-75.3051535
01/01/2013 12:00:00 AM,42127,Northeast,Pocono Counties WDA,Wayne,64,45 to 64 Years,Female,8026,529,3414,1438,924,942,779,1721,2645,41.6496981,-75.3051535
01/01/2014 12:00:00 AM,42127,Northeast,Pocono Counties WDA,Wayne,64,45 to 64 Years,Male,8713,1034,3784,1601,541,1005,748,1753,2294,41.6496981,-75.3051535
01/01/2016 12:00:00 AM,42127,Northeast,Pocono Counties WDA,Wayne,64,45 to 64 Years,Male,8618,977,3944,1543,565,845,744,1589,2154,41.6496981,-75.3051535
01/01/2011 12:00:00 AM,42127,Northeast,Pocono Counties WDA,Wayne,64,45 to 64 Years,Female,7903,547,3557,1349,925,788,737,1525,2450,41.6496981,-75.3051535
01/01/2015 12:00:00 AM,42127,Northeast,Pocono Counties WDA,Wayne,64,45 to 64 Years,Male,8670,1031,3962,1510,558,888,721,1609,2167,41.6496981,-75.3051535
01/01/2010 12:00:00 AM,42127,Northeast,Pocono Counties WDA,Wayne,64,45 to 64 Years,Male,8547,1141,3714,1534,550,895,713,1608,2158,41.6496981,-75.3051535
01/01/2014 12:00:00 AM,42127,Northeast,Pocono Counties WDA,Wayne,64,45 to 64 Years,Female,8019,535,3302,1466,889,1115,712,1827,2716,41.6496981,-75.3051535
01/01/2015 12:00:00 AM,42127,Northeast,Pocono Counties WDA,Wayne,64,45 to 64 Years,Female,7924,491,3370,1399,897,1055,712,1767,2664,41.6496981,-75.3051535
01/01/2016 12:00:00 AM,42127,Northeast,Pocono Counties WDA,Wayne,64,45 to 64 Years,Female,7819,466,3223,1460,865,1148,657,1805,2670,41.6496981,-75.3051535
01/01/2010 12:00:00 AM,42127,Northeast,Pocono Counties WDA,Wayne,64,45 to 64 Years,Female,7851,602,3526,1321,802,944,656,1600,2402,41.6496981,-75.3051535
01/01/2011 12:00:00 AM,42127,Northeast,Pocono Counties WDA,Wayne,64,35 to 44 Years,Female,3138,174,1199,758,351,336,320,656,1007,41.6496981,-75.3051535
01/01/2012 12:00:00 AM,42127,Northeast,Pocono Counties WDA,Wayne,64,35 to 44 Years,Female,2992,240,1050,721,304,365,312,677,981,41.6496981,-75.3051535
01/01/2013 12:00:00 AM,42127,Northeast,Pocono Counties WDA,Wayne,64,35 to 44 Years,Female,2849,233,1081,601,298,325,311,636,934,41.6496981,-75.3051535
01/01/2010 12:00:00 AM,42127,Northeast,Pocono Counties WDA,Wayne,64,35 to 44 Years,Female,3231,206,1186,716,328,499,296,795,1123,41.6496981,-75.3051535
01/01/2014 12:00:00 AM,42127,Northeast,Pocono Counties WDA,Wayne,64,25 to 34 Years,Female,2167,67,601,536,184,484,295,779,963,41.6496981,-75.3051535
01/01/2014 12:00:00 AM,42127,Northeast,Pocono Counties WDA,Wayne,64,35 to 44 Years,Female,2737,195,1065,611,269,307,290,597,866,41.6496981,-75.3051535
01/01/2016 12:00:00 AM,42127,Northeast,Pocono Counties WDA,Wayne,64,25 to 34 Years,Female,2230,61,604,471,279,538,277,815,1094,41.6496981,-75.3051535
01/01/2015 12:00:00 AM,42127,Northeast,Pocono Counties WDA,Wayne,64,35 to 44 Years,Female,2647,168,946,593,288,376,276,652,940,41.6496981,-75.3051535
01/01/2016 12:00:00 AM,42127,Northeast,Pocono Counties WDA,Wayne,64,35 to 44 Years,Female,2538,157,860,650,254,343,274,617,871,41.6496981,-75.3051535
01/01/2013 12:00:00 AM,42127,Northeast,Pocono Counties WDA,Wayne,64,25 to 34 Years,Female,2162,67,639,532,226,435,263,698,924,41.6496981,-75.3051535
01/01/2015 12:00:00 AM,42127,Northeast,Pocono Counties WDA,Wayne,64,25 to 34 Years,Female,2178,76,610,523,224,495,250,745,969,41.6496981,-75.3051535
01/01/2010 12:00:00 AM,42127,Northeast,Pocono Counties WDA,Wayne,64,25 to 34 Years,Male,2935,422,1226,445,233,370,239,609,842,41.6496981,-75.3051535
01/01/2012 12:00:00 AM,42127,Northeast,Pocono Counties WDA,Wayne,64,25 to 34 Years,Female,2148,96,689,540,197,406,220,626,823,41.6496981,-75.3051535
01/01/2011 12:00:00 AM,42127,Northeast,Pocono Counties WDA,Wayne,64,25 to 34 Years,Female,2128,88,739,531,198,390,182,572,770,41.6496981,-75.3051535
01/01/2010 12:00:00 AM,42127,Northeast,Pocono Counties WDA,Wayne,64,25 to 34 Years,Female,2237,174,778,480,232,397,176,573,805,41.6496981,-75.3051535
01/01/2016 12:00:00 AM,42127,Northeast,Pocono Counties WDA,Wayne,64,35 to 44 Years,Male,3454,354,1658,784,213,287,158,445,658,41.6496981,-75.3051535
01/01/2010 12:00:00 AM,42127,Northeast,Pocono Counties WDA,Wayne,64,35 to 44 Years,Male,3893,517,1863,734,307,323,149,472,779,41.6496981,-75.3051535
01/01/2011 12:00:00 AM,42127,Northeast,Pocono Counties WDA,Wayne,64,35 to 44 Years,Male,3933,477,1892,746,358,350,110,460,818,41.6496981,-75.3051535
01/01/2012 12:00:00 AM,42127,Northeast,Pocono Counties WDA,Wayne,64,25 to 34 Years,Male,2956,365,1374,497,232,380,108,488,720,41.6496981,-75.3051535
01/01/2012 12:00:00 AM,42127,Northeast,Pocono Counties WDA,Wayne,64,35 to 44 Years,Male,3850,462,1819,796,328,337,108,445,773,41.6496981,-75.3051535
01/01/2015 12:00:00 AM,42127,Northeast,Pocono Counties WDA,Wayne,64,35 to 44 Years,Male,3644,373,1780,819,236,332,104,436,672,41.6496981,-75.3051535
01/01/2013 12:00:00 AM,42127,Northeast,Pocono Counties WDA,Wayne,64,25 to 34 Years,Male,2997,342,1356,570,256,370,103,473,729,41.6496981,-75.3051535
01/01/2011 12:00:00 AM,42127,Northeast,Pocono Counties WDA,Wayne,64,25 to 34 Years,Male,2971,333,1475,539,224,300,100,400,624,41.6496981,-75.3051535
01/01/2014 12:00:00 AM,42127,Northeast,Pocono Counties WDA,Wayne,64,35 to 44 Years,Male,3729,453,1721,909,227,337,82,419,646,41.6496981,-75.3051535
01/01/2014 12:00:00 AM,42127,Northeast,Pocono Counties WDA,Wayne,64,25 to 34 Years,Male,3091,425,1397,612,237,339,81,420,657,41.6496981,-75.3051535
01/01/2013 12:00:00 AM,42127,Northeast,Pocono Counties WDA,Wayne,64,35 to 44 Years,Male,3826,462,1803,848,254,384,75,459,713,41.6496981,-75.3051535
01/01/2016 12:00:00 AM,42127,Northeast,Pocono Counties WDA,Wayne,64,25 to 34 Years,Male,3280,406,1472,677,227,428,70,498,725,41.6496981,-75.3051535
01/01/2015 12:00:00 AM,42127,Northeast,Pocono Counties WDA,Wayne,64,25 to 34 Years,Male,3170,368,1542,607,208,387,58,445,653,41.6496981,-75.3051535
01/01/2014 12:00:00 AM,42131,Northeast,Northern Tier WDA,Wyoming,66,35 to 44 Years,Female,1722,73,680,383,238,253,95,348,586,41.5189249,-76.01813
01/01/2012 12:00:00 AM,42131,Northeast,Northern Tier WDA,Wyoming,66,45 to 64 Years,Female,4222,327,1927,719,388,490,371,861,1249,41.5189249,-76.01813
01/01/2010 12:00:00 AM,42131,Northeast,Northern Tier WDA,Wyoming,66,45 to 64 Years,Female,4164,309,2031,702,345,422,355,777,1122,41.5189249,-76.01813
01/01/2011 12:00:00 AM,42131,Northeast,Northern Tier WDA,Wyoming,66,45 to 64 Years,Female,4205,306,2047,711,353,437,351,788,1141,41.5189249,-76.01813
01/01/2013 12:00:00 AM,42131,Northeast,Northern Tier WDA,Wyoming,66,45 to 64 Years,Female,4197,335,1938,702,387,498,337,835,1222,41.5189249,-76.01813
01/01/2014 12:00:00 AM,42131,Northeast,Northern Tier WDA,Wyoming,66,45 to 64 Years,Female,4214,302,1928,664,430,557,333,890,1320,41.5189249,-76.01813
01/01/2016 12:00:00 AM,42131,Northeast,Northern Tier WDA,Wyoming,66,45 to 64 Years,Female,4170,257,1938,653,453,549,320,869,1322,41.5189249,-76.01813
01/01/2015 12:00:00 AM,42131,Northeast,Northern Tier WDA,Wyoming,66,45 to 64 Years,Female,4214,262,1898,674,456,616,308,924,1380,41.5189249,-76.01813
01/01/2010 12:00:00 AM,42131,Northeast,Northern Tier WDA,Wyoming,66,45 to 64 Years,Male,4255,342,2095,774,396,359,289,648,1044,41.5189249,-76.01813
01/01/2012 12:00:00 AM,42131,Northeast,Northern Tier WDA,Wyoming,66,45 to 64 Years,Male,4314,385,2172,713,405,365,274,639,1044,41.5189249,-76.01813
01/01/2011 12:00:00 AM,42131,Northeast,Northern Tier WDA,Wyoming,66,45 to 64 Years,Male,4284,399,2136,729,383,363,274,637,1020,41.5189249,-76.01813
01/01/2016 12:00:00 AM,42131,Northeast,Northern Tier WDA,Wyoming,66,45 to 64 Years,Male,4146,334,2127,628,383,418,256,674,1057,41.5189249,-76.01813
01/01/2013 12:00:00 AM,42131,Northeast,Northern Tier WDA,Wyoming,66,45 to 64 Years,Male,4278,406,2139,733,380,383,237,620,1000,41.5189249,-76.01813
01/01/2015 12:00:00 AM,42131,Northeast,Northern Tier WDA,Wyoming,66,45 to 64 Years,Male,4179,375,2224,633,346,393,208,601,947,41.5189249,-76.01813
01/01/2014 12:00:00 AM,42131,Northeast,Northern Tier WDA,Wyoming,66,45 to 64 Years,Male,4239,391,2212,671,360,401,204,605,965,41.5189249,-76.01813
01/01/2016 12:00:00 AM,42131,Northeast,Northern Tier WDA,Wyoming,66,25 to 34 Years,Female,1477,72,522,279,146,282,176,458,604,41.5189249,-76.01813
01/01/2015 12:00:00 AM,42131,Northeast,Northern Tier WDA,Wyoming,66,25 to 34 Years,Female,1482,80,532,276,160,277,157,434,594,41.5189249,-76.01813
01/01/2014 12:00:00 AM,42131,Northeast,Northern Tier WDA,Wyoming,66,25 to 34 Years,Female,1481,108,504,286,158,301,124,425,583,41.5189249,-76.01813
01/01/2016 12:00:00 AM,42131,Northeast,Northern Tier WDA,Wyoming,66,35 to 44 Years,Female,1630,41,633,368,214,253,121,374,588,41.5189249,-76.01813
01/01/2015 12:00:00 AM,42131,Northeast,Northern Tier WDA,Wyoming,66,35 to 44 Years,Female,1683,49,685,387,180,267,115,382,562,41.5189249,-76.01813
01/01/2011 12:00:00 AM,42131,Northeast,Northern Tier WDA,Wyoming,66,35 to 44 Years,Female,1861,63,798,325,238,331,106,437,675,41.5189249,-76.01813
01/01/2012 12:00:00 AM,42131,Northeast,Northern Tier WDA,Wyoming,66,35 to 44 Years,Female,1829,69,807,347,250,251,105,356,606,41.5189249,-76.01813
01/01/2013 12:00:00 AM,42131,Northeast,Northern Tier WDA,Wyoming,66,35 to 44 Years,Female,1780,65,773,370,253,225,94,319,572,41.5189249,-76.01813
01/01/2013 12:00:00 AM,42131,Northeast,Northern Tier WDA,Wyoming,66,25 to 34 Years,Female,1506,122,531,296,135,334,88,422,557,41.5189249,-76.01813
01/01/2012 12:00:00 AM,42131,Northeast,Northern Tier WDA,Wyoming,66,25 to 34 Years,Female,1501,123,499,353,108,333,85,418,526,41.5189249,-76.01813
01/01/2010 12:00:00 AM,42131,Northeast,Northern Tier WDA,Wyoming,66,35 to 44 Years,Female,1899,60,818,343,262,339,77,416,678,41.5189249,-76.01813
01/01/2014 12:00:00 AM,42131,Northeast,Northern Tier WDA,Wyoming,66,35 to 44 Years,Male,1667,160,782,271,131,254,69,323,454,41.5189249,-76.01813
01/01/2011 12:00:00 AM,42131,Northeast,Northern Tier WDA,Wyoming,66,25 to 34 Years,Female,1491,132,543,339,114,302,61,363,477,41.5189249,-76.01813
01/01/2010 12:00:00 AM,42131,Northeast,Northern Tier WDA,Wyoming,66,35 to 44 Years,Male,1832,163,936,231,174,268,60,328,502,41.5189249,-76.01813
01/01/2015 12:00:00 AM,42131,Northeast,Northern Tier WDA,Wyoming,66,35 to 44 Years,Male,1610,134,761,301,129,229,56,285,414,41.5189249,-76.01813
01/01/2013 12:00:00 AM,42131,Northeast,Northern Tier WDA,Wyoming,66,35 to 44 Years,Male,1704,188,830,220,134,278,54,332,466,41.5189249,-76.01813
01/01/2010 12:00:00 AM,42131,Northeast,Northern Tier WDA,Wyoming,66,25 to 34 Years,Female,1501,130,538,380,114,286,53,339,453,41.5189249,-76.01813
01/01/2016 12:00:00 AM,42131,Northeast,Northern Tier WDA,Wyoming,66,35 to 44 Years,Male,1570,118,741,293,133,232,53,285,418,41.5189249,-76.01813
01/01/2012 12:00:00 AM,42131,Northeast,Northern Tier WDA,Wyoming,66,35 to 44 Years,Male,1749,195,829,213,159,302,51,353,512,41.5189249,-76.01813
01/01/2016 12:00:00 AM,42131,Northeast,Northern Tier WDA,Wyoming,66,25 to 34 Years,Male,1571,121,765,275,125,235,50,285,410,41.5189249,-76.01813
01/01/2011 12:00:00 AM,42131,Northeast,Northern Tier WDA,Wyoming,66,35 to 44 Years,Male,1812,202,897,196,188,280,49,329,517,41.5189249,-76.01813
01/01/2010 12:00:00 AM,42131,Northeast,Northern Tier WDA,Wyoming,66,25 to 34 Years,Male,1457,176,681,251,86,218,45,263,349,41.5189249,-76.01813
01/01/2014 12:00:00 AM,42131,Northeast,Northern Tier WDA,Wyoming,66,25 to 34 Years,Male,1559,169,788,225,116,218,43,261,377,41.5189249,-76.01813
01/01/2013 12:00:00 AM,42131,Northeast,Northern Tier WDA,Wyoming,66,25 to 34 Years,Male,1508,185,737,218,101,227,40,267,368,41.5189249,-76.01813
01/01/2015 12:00:00 AM,42131,Northeast,Northern Tier WDA,Wyoming,66,25 to 34 Years,Male,1557,134,769,234,136,245,39,284,420,41.5189249,-76.01813
01/01/2011 12:00:00 AM,42131,Northeast,Northern Tier WDA,Wyoming,66,25 to 34 Years,Male,1485,161,726,239,82,238,39,277,359,41.5189249,-76.01813
01/01/2012 12:00:00 AM,42131,Northeast,Northern Tier WDA,Wyoming,66,25 to 34 Years,Male,1471,157,708,260,70,237,39,276,346,41.5189249,-76.01813
01/01/2010 12:00:00 AM,42053,Northwest,Northwest WDA,Forest,27,35 to 44 Years,Male,724,141,351,128,45,30,29,59,104,41.5135788,-79.2378099
01/01/2010 12:00:00 AM,42053,Northwest,Northwest WDA,Forest,27,45 to 64 Years,Male,1262,239,630,163,80,55,95,150,230,41.5135788,-79.2378099
01/01/2012 12:00:00 AM,42053,Northwest,Northwest WDA,Forest,27,45 to 64 Years,Female,878,69,486,107,80,66,70,136,216,41.5135788,-79.2378099
01/01/2012 12:00:00 AM,42053,Northwest,Northwest WDA,Forest,27,45 to 64 Years,Male,1308,242,650,216,91,45,64,109,200,41.5135788,-79.2378099
01/01/2010 12:00:00 AM,42053,Northwest,Northwest WDA,Forest,27,45 to 64 Years,Female,871,85,509,109,56,50,62,112,168,41.5135788,-79.2378099
01/01/2011 12:00:00 AM,42053,Northwest,Northwest WDA,Forest,27,45 to 64 Years,Female,881,90,504,100,56,70,61,131,187,41.5135788,-79.2378099
01/01/2011 12:00:00 AM,42053,Northwest,Northwest WDA,Forest,27,45 to 64 Years,Male,1287,206,630,233,125,35,58,93,218,41.5135788,-79.2378099
01/01/2016 12:00:00 AM,42053,Northwest,Northwest WDA,Forest,27,45 to 64 Years,Male,1249,231,597,210,77,78,56,134,211,41.5135788,-79.2378099
01/01/2015 12:00:00 AM,42053,Northwest,Northwest WDA,Forest,27,45 to 64 Years,Female,899,71,522,121,64,65,56,121,185,41.5135788,-79.2378099
01/01/2016 12:00:00 AM,42053,Northwest,Northwest WDA,Forest,27,45 to 64 Years,Female,640,37,385,83,49,38,48,86,135,41.5135788,-79.2378099
01/01/2013 12:00:00 AM,42053,Northwest,Northwest WDA,Forest,27,45 to 64 Years,Female,887,75,496,146,65,61,44,105,170,41.5135788,-79.2378099
01/01/2014 12:00:00 AM,42053,Northwest,Northwest WDA,Forest,27,45 to 64 Years,Female,895,57,498,166,59,72,43,115,174,41.5135788,-79.2378099
01/01/2014 12:00:00 AM,42053,Northwest,Northwest WDA,Forest,27,45 to 64 Years,Male,1083,191,468,232,78,75,39,114,192,41.5135788,-79.2378099
01/01/2010 12:00:00 AM,42053,Northwest,Northwest WDA,Forest,27,25 to 34 Years,Male,925,282,420,148,30,14,31,45,75,41.5135788,-79.2378099
01/01/2013 12:00:00 AM,42053,Northwest,Northwest WDA,Forest,27,45 to 64 Years,Male,1092,214,497,213,73,70,25,95,168,41.5135788,-79.2378099
01/01/2015 12:00:00 AM,42053,Northwest,Northwest WDA,Forest,27,45 to 64 Years,Male,1146,206,543,219,85,69,24,93,178,41.5135788,-79.2378099
01/01/2012 12:00:00 AM,42053,Northwest,Northwest WDA,Forest,27,25 to 34 Years,Male,997,245,518,175,10,28,21,49,59,41.5135788,-79.2378099
01/01/2014 12:00:00 AM,42053,Northwest,Northwest WDA,Forest,27,25 to 34 Years,Female,128,2,30,14,39,23,20,43,82,41.5135788,-79.2378099
01/01/2012 12:00:00 AM,42053,Northwest,Northwest WDA,Forest,27,35 to 44 Years,Male,720,190,388,80,22,21,19,40,62,41.5135788,-79.2378099
01/01/2011 12:00:00 AM,42053,Northwest,Northwest WDA,Forest,27,25 to 34 Years,Male,903,219,398,245,12,10,19,29,41,41.5135788,-79.2378099
01/01/2013 12:00:00 AM,42053,Northwest,Northwest WDA,Forest,27,25 to 34 Years,Female,193,2,57,60,47,11,16,27,74,41.5135788,-79.2378099
01/01/2011 12:00:00 AM,42053,Northwest,Northwest WDA,Forest,27,35 to 44 Years,Male,718,245,350,51,44,13,15,28,72,41.5135788,-79.2378099
01/01/2010 12:00:00 AM,42053,Northwest,Northwest WDA,Forest,27,25 to 34 Years,Female,200,0,111,24,43,8,14,22,65,41.5135788,-79.2378099
01/01/2012 12:00:00 AM,42053,Northwest,Northwest WDA,Forest,27,25 to 34 Years,Female,184,1,76,49,39,9,10,19,58,41.5135788,-79.2378099
01/01/2014 12:00:00 AM,42053,Northwest,Northwest WDA,Forest,27,35 to 44 Years,Female,263,33,103,32,44,44,7,51,95,41.5135788,-79.2378099
01/01/2013 12:00:00 AM,42053,Northwest,Northwest WDA,Forest,27,35 to 44 Years,Female,267,46,122,36,21,35,7,42,63,41.5135788,-79.2378099
01/01/2012 12:00:00 AM,42053,Northwest,Northwest WDA,Forest,27,35 to 44 Years,Female,275,79,120,34,22,13,7,20,42,41.5135788,-79.2378099
01/01/2011 12:00:00 AM,42053,Northwest,Northwest WDA,Forest,27,25 to 34 Years,Female,190,0,93,45,34,12,6,18,52,41.5135788,-79.2378099
01/01/2011 12:00:00 AM,42053,Northwest,Northwest WDA,Forest,27,35 to 44 Years,Female,292,27,169,55,15,21,5,26,41,41.5135788,-79.2378099
01/01/2010 12:00:00 AM,42053,Northwest,Northwest WDA,Forest,27,35 to 44 Years,Female,300,28,158,62,29,18,5,23,52,41.5135788,-79.2378099
01/01/2015 12:00:00 AM,42053,Northwest,Northwest WDA,Forest,27,25 to 34 Years,Female,46,1,16,12,9,4,4,8,17,41.5135788,-79.2378099
01/01/2014 12:00:00 AM,42053,Northwest,Northwest WDA,Forest,27,25 to 34 Years,Male,1244,290,653,263,6,30,2,32,38,41.5135788,-79.2378099
01/01/2015 12:00:00 AM,42053,Northwest,Northwest WDA,Forest,27,35 to 44 Years,Female,74,10,35,9,6,12,2,14,20,41.5135788,-79.2378099
01/01/2016 12:00:00 AM,42053,Northwest,Northwest WDA,Forest,27,35 to 44 Years,Female,60,6,27,10,5,10,2,12,17,41.5135788,-79.2378099
01/01/2016 12:00:00 AM,42053,Northwest,Northwest WDA,Forest,27,25 to 34 Years,Male,1656,477,896,250,7,25,1,26,33,41.5135788,-79.2378099
01/01/2015 12:00:00 AM,42053,Northwest,Northwest WDA,Forest,27,25 to 34 Years,Male,1345,395,713,207,5,24,1,25,30,41.5135788,-79.2378099
01/01/2013 12:00:00 AM,42053,Northwest,Northwest WDA,Forest,27,25 to 34 Years,Male,1086,270,516,270,10,19,1,20,30,41.5135788,-79.2378099
01/01/2016 12:00:00 AM,42053,Northwest,Northwest WDA,Forest,27,25 to 34 Years,Female,41,1,16,11,9,3,1,4,13,41.5135788,-79.2378099
01/01/2014 12:00:00 AM,42053,Northwest,Northwest WDA,Forest,27,35 to 44 Years,Male,1019,220,623,124,25,27,0,27,52,41.5135788,-79.2378099
01/01/2015 12:00:00 AM,42053,Northwest,Northwest WDA,Forest,27,35 to 44 Years,Male,1163,276,767,59,36,25,0,25,61,41.5135788,-79.2378099
01/01/2013 12:00:00 AM,42053,Northwest,Northwest WDA,Forest,27,35 to 44 Years,Male,935,202,568,76,70,19,0,19,89,41.5135788,-79.2378099
01/01/2016 12:00:00 AM,42053,Northwest,Northwest WDA,Forest,27,35 to 44 Years,Male,1241,268,842,82,30,19,0,19,49,41.5135788,-79.2378099
01/01/2013 12:00:00 AM,42113,Northeast,Northern Tier WDA,Sullivan,57,45 to 64 Years,Female,1045,69,495,214,99,82,86,168,267,41.4480994,-76.5147922
01/01/2014 12:00:00 AM,42113,Northeast,Northern Tier WDA,Sullivan,57,45 to 64 Years,Female,1036,50,509,202,81,115,79,194,275,41.4480994,-76.5147922
01/01/2011 12:00:00 AM,42113,Northeast,Northern Tier WDA,Sullivan,57,45 to 64 Years,Female,1025,99,502,196,79,70,79,149,228,41.4480994,-76.5147922
01/01/2015 12:00:00 AM,42113,Northeast,Northern Tier WDA,Sullivan,57,45 to 64 Years,Female,1013,43,486,202,81,123,78,201,282,41.4480994,-76.5147922
01/01/2016 12:00:00 AM,42113,Northeast,Northern Tier WDA,Sullivan,57,45 to 64 Years,Female,992,51,480,188,90,111,72,183,273,41.4480994,-76.5147922
01/01/2010 12:00:00 AM,42113,Northeast,Northern Tier WDA,Sullivan,57,45 to 64 Years,Female,1007,119,518,141,87,70,72,142,229,41.4480994,-76.5147922
01/01/2012 12:00:00 AM,42113,Northeast,Northern Tier WDA,Sullivan,57,45 to 64 Years,Female,1021,87,479,205,104,75,71,146,250,41.4480994,-76.5147922
01/01/2013 12:00:00 AM,42113,Northeast,Northern Tier WDA,Sullivan,57,45 to 64 Years,Male,1081,78,476,190,167,111,59,170,337,41.4480994,-76.5147922
01/01/2015 12:00:00 AM,42113,Northeast,Northern Tier WDA,Sullivan,57,45 to 64 Years,Male,1095,93,534,191,129,90,58,148,277,41.4480994,-76.5147922
01/01/2012 12:00:00 AM,42113,Northeast,Northern Tier WDA,Sullivan,57,45 to 64 Years,Male,1064,99,476,175,164,95,55,150,314,41.4480994,-76.5147922
01/01/2014 12:00:00 AM,42113,Northeast,Northern Tier WDA,Sullivan,57,45 to 64 Years,Male,1104,95,514,201,124,116,54,170,294,41.4480994,-76.5147922
01/01/2016 12:00:00 AM,42113,Northeast,Northern Tier WDA,Sullivan,57,45 to 64 Years,Male,1092,126,528,184,113,95,46,141,254,41.4480994,-76.5147922
01/01/2011 12:00:00 AM,42113,Northeast,Northern Tier WDA,Sullivan,57,45 to 64 Years,Male,1082,109,485,165,176,103,44,147,323,41.4480994,-76.5147922
01/01/2010 12:00:00 AM,42113,Northeast,Northern Tier WDA,Sullivan,57,45 to 64 Years,Male,1042,111,501,164,156,71,39,110,266,41.4480994,-76.5147922
01/01/2011 12:00:00 AM,42113,Northeast,Northern Tier WDA,Sullivan,57,35 to 44 Years,Female,332,14,167,51,30,47,23,70,100,41.4480994,-76.5147922
01/01/2015 12:00:00 AM,42113,Northeast,Northern Tier WDA,Sullivan,57,25 to 34 Years,Female,255,10,90,56,19,61,19,80,99,41.4480994,-76.5147922
01/01/2014 12:00:00 AM,42113,Northeast,Northern Tier WDA,Sullivan,57,25 to 34 Years,Female,252,31,70,55,18,59,19,78,96,41.4480994,-76.5147922
01/01/2011 12:00:00 AM,42113,Northeast,Northern Tier WDA,Sullivan,57,25 to 34 Years,Female,231,22,79,45,24,43,18,61,85,41.4480994,-76.5147922
01/01/2010 12:00:00 AM,42113,Northeast,Northern Tier WDA,Sullivan,57,25 to 34 Years,Female,219,18,80,43,18,42,18,60,78,41.4480994,-76.5147922
01/01/2013 12:00:00 AM,42113,Northeast,Northern Tier WDA,Sullivan,57,25 to 34 Years,Female,243,34,68,53,28,44,16,60,88,41.4480994,-76.5147922
01/01/2012 12:00:00 AM,42113,Northeast,Northern Tier WDA,Sullivan,57,35 to 44 Years,Female,307,12,141,42,36,61,15,76,112,41.4480994,-76.5147922
01/01/2013 12:00:00 AM,42113,Northeast,Northern Tier WDA,Sullivan,57,35 to 44 Years,Female,289,11,149,32,26,57,14,71,97,41.4480994,-76.5147922
01/01/2016 12:00:00 AM,42113,Northeast,Northern Tier WDA,Sullivan,57,25 to 34 Years,Female,253,11,96,66,14,52,14,66,80,41.4480994,-76.5147922
01/01/2012 12:00:00 AM,42113,Northeast,Northern Tier WDA,Sullivan,57,25 to 34 Years,Female,232,28,79,38,31,42,14,56,87,41.4480994,-76.5147922
01/01/2010 12:00:00 AM,42113,Northeast,Northern Tier WDA,Sullivan,57,35 to 44 Years,Female,338,19,175,78,22,30,14,44,66,41.4480994,-76.5147922
01/01/2015 12:00:00 AM,42113,Northeast,Northern Tier WDA,Sullivan,57,25 to 34 Years,Male,282,20,155,45,18,31,13,44,62,41.4480994,-76.5147922
01/01/2016 12:00:00 AM,42113,Northeast,Northern Tier WDA,Sullivan,57,25 to 34 Years,Male,294,21,174,48,11,27,13,40,51,41.4480994,-76.5147922
01/01/2015 12:00:00 AM,42113,Northeast,Northern Tier WDA,Sullivan,57,35 to 44 Years,Female,279,3,114,47,41,63,11,74,115,41.4480994,-76.5147922
01/01/2014 12:00:00 AM,42113,Northeast,Northern Tier WDA,Sullivan,57,35 to 44 Years,Female,283,3,137,42,31,59,11,70,101,41.4480994,-76.5147922
01/01/2013 12:00:00 AM,42113,Northeast,Northern Tier WDA,Sullivan,57,25 to 34 Years,Male,278,31,157,39,26,15,10,25,51,41.4480994,-76.5147922
01/01/2014 12:00:00 AM,42113,Northeast,Northern Tier WDA,Sullivan,57,25 to 34 Years,Male,298,35,148,55,17,35,8,43,60,41.4480994,-76.5147922
01/01/2016 12:00:00 AM,42113,Northeast,Northern Tier WDA,Sullivan,57,35 to 44 Years,Female,280,3,107,60,55,48,7,55,110,41.4480994,-76.5147922
01/01/2011 12:00:00 AM,42113,Northeast,Northern Tier WDA,Sullivan,57,35 to 44 Years,Male,326,68,192,30,23,8,5,13,36,41.4480994,-76.5147922
01/01/2010 12:00:00 AM,42113,Northeast,Northern Tier WDA,Sullivan,57,35 to 44 Years,Male,328,39,200,36,41,9,3,12,53,41.4480994,-76.5147922
01/01/2015 12:00:00 AM,42113,Northeast,Northern Tier WDA,Sullivan,57,35 to 44 Years,Male,307,29,175,40,55,5,3,8,63,41.4480994,-76.5147922
01/01/2012 12:00:00 AM,42113,Northeast,Northern Tier WDA,Sullivan,57,35 to 44 Years,Male,329,71,172,43,31,10,2,12,43,41.4480994,-76.5147922
01/01/2014 12:00:00 AM,42113,Northeast,Northern Tier WDA,Sullivan,57,35 to 44 Years,Male,309,43,185,39,31,9,2,11,42,41.4480994,-76.5147922
01/01/2013 12:00:00 AM,42113,Northeast,Northern Tier WDA,Sullivan,57,35 to 44 Years,Male,320,65,175,36,35,7,2,9,44,41.4480994,-76.5147922
01/01/2012 12:00:00 AM,42113,Northeast,Northern Tier WDA,Sullivan,57,25 to 34 Years,Male,288,27,165,46,26,24,0,24,50,41.4480994,-76.5147922
01/01/2011 12:00:00 AM,42113,Northeast,Northern Tier WDA,Sullivan,57,25 to 34 Years,Male,282,31,128,70,32,21,0,21,53,41.4480994,-76.5147922
01/01/2010 12:00:00 AM,42113,Northeast,Northern Tier WDA,Sullivan,57,25 to 34 Years,Male,251,20,120,63,37,11,0,11,48,41.4480994,-76.5147922
01/01/2016 12:00:00 AM,42113,Northeast,Northern Tier WDA,Sullivan,57,35 to 44 Years,Male,312,24,194,37,52,5,0,5,57,41.4480994,-76.5147922
01/01/2012 12:00:00 AM,42069,Northeast,Lackawanna County WDA,Lackawanna,35,45 to 64 Years,Female,30664,2129,12274,5428,2623,4641,3569,8210,10833,41.4391006,-75.6121835
01/01/2011 12:00:00 AM,42069,Northeast,Lackawanna County WDA,Lackawanna,35,45 to 64 Years,Female,30525,2170,12216,5423,2605,4558,3553,8111,10716,41.4391006,-75.6121835
01/01/2013 12:00:00 AM,42069,Northeast,Lackawanna County WDA,Lackawanna,35,45 to 64 Years,Female,30786,2230,12121,5429,2861,4707,3438,8145,11006,41.4391006,-75.6121835
01/01/2014 12:00:00 AM,42069,Northeast,Lackawanna County WDA,Lackawanna,35,45 to 64 Years,Female,30764,2213,11801,5500,3100,4754,3396,8150,11250,41.4391006,-75.6121835
01/01/2010 12:00:00 AM,42069,Northeast,Lackawanna County WDA,Lackawanna,35,45 to 64 Years,Female,30088,2300,12562,5173,2314,4489,3250,7739,10053,41.4391006,-75.6121835
01/01/2015 12:00:00 AM,42069,Northeast,Lackawanna County WDA,Lackawanna,35,45 to 64 Years,Female,30613,2207,11511,5588,3179,4885,3243,8128,11307,41.4391006,-75.6121835
01/01/2016 12:00:00 AM,42069,Northeast,Lackawanna County WDA,Lackawanna,35,45 to 64 Years,Female,30369,2210,11381,5476,3161,5035,3106,8141,11302,41.4391006,-75.6121835
01/01/2012 12:00:00 AM,42069,Northeast,Lackawanna County WDA,Lackawanna,35,45 to 64 Years,Male,29558,2846,10614,4615,3212,5205,3066,8271,11483,41.4391006,-75.6121835
01/01/2010 12:00:00 AM,42069,Northeast,Lackawanna County WDA,Lackawanna,35,45 to 64 Years,Male,28933,2730,10747,4692,3123,4580,3061,7641,10764,41.4391006,-75.6121835
01/01/2011 12:00:00 AM,42069,Northeast,Lackawanna County WDA,Lackawanna,35,45 to 64 Years,Male,29156,2794,10534,4618,3158,5007,3045,8052,11210,41.4391006,-75.6121835
01/01/2013 12:00:00 AM,42069,Northeast,Lackawanna County WDA,Lackawanna,35,45 to 64 Years,Male,29445,2445,10641,4773,3260,5350,2976,8326,11586,41.4391006,-75.6121835
01/01/2014 12:00:00 AM,42069,Northeast,Lackawanna County WDA,Lackawanna,35,45 to 64 Years,Male,29448,2450,10765,4974,3230,5213,2816,8029,11259,41.4391006,-75.6121835
01/01/2016 12:00:00 AM,42069,Northeast,Lackawanna County WDA,Lackawanna,35,45 to 64 Years,Male,28970,2559,10631,5235,3004,4735,2806,7541,10545,41.4391006,-75.6121835
01/01/2015 12:00:00 AM,42069,Northeast,Lackawanna County WDA,Lackawanna,35,45 to 64 Years,Male,29276,2460,10770,5252,3105,4963,2726,7689,10794,41.4391006,-75.6121835
01/01/2012 12:00:00 AM,42069,Northeast,Lackawanna County WDA,Lackawanna,35,35 to 44 Years,Female,13265,1016,3656,2495,1620,2438,2040,4478,6098,41.4391006,-75.6121835
01/01/2013 12:00:00 AM,42069,Northeast,Lackawanna County WDA,Lackawanna,35,35 to 44 Years,Female,12930,1007,3490,2397,1489,2562,1985,4547,6036,41.4391006,-75.6121835
01/01/2014 12:00:00 AM,42069,Northeast,Lackawanna County WDA,Lackawanna,35,35 to 44 Years,Female,12683,813,3436,2677,1381,2498,1878,4376,5757,41.4391006,-75.6121835
01/01/2015 12:00:00 AM,42069,Northeast,Lackawanna County WDA,Lackawanna,35,35 to 44 Years,Female,12434,840,3274,2456,1353,2646,1865,4511,5864,41.4391006,-75.6121835
01/01/2011 12:00:00 AM,42069,Northeast,Lackawanna County WDA,Lackawanna,35,35 to 44 Years,Female,13572,1078,3873,2620,1564,2575,1862,4437,6001,41.4391006,-75.6121835
01/01/2016 12:00:00 AM,42069,Northeast,Lackawanna County WDA,Lackawanna,35,35 to 44 Years,Female,12283,916,3244,2172,1367,2734,1850,4584,5951,41.4391006,-75.6121835
01/01/2010 12:00:00 AM,42069,Northeast,Lackawanna County WDA,Lackawanna,35,35 to 44 Years,Female,14042,1183,4233,2556,1668,2604,1798,4402,6070,41.4391006,-75.6121835
01/01/2014 12:00:00 AM,42069,Northeast,Lackawanna County WDA,Lackawanna,35,25 to 34 Years,Female,12581,847,3024,2503,1238,3174,1795,4969,6207,41.4391006,-75.6121835
01/01/2015 12:00:00 AM,42069,Northeast,Lackawanna County WDA,Lackawanna,35,25 to 34 Years,Female,12765,1061,2838,2500,1301,3339,1726,5065,6366,41.4391006,-75.6121835
01/01/2011 12:00:00 AM,42069,Northeast,Lackawanna County WDA,Lackawanna,35,25 to 34 Years,Female,12298,929,3563,2031,1244,2867,1664,4531,5775,41.4391006,-75.6121835
01/01/2013 12:00:00 AM,42069,Northeast,Lackawanna County WDA,Lackawanna,35,25 to 34 Years,Female,12416,910,3010,2399,1240,3206,1651,4857,6097,41.4391006,-75.6121835
01/01/2016 12:00:00 AM,42069,Northeast,Lackawanna County WDA,Lackawanna,35,25 to 34 Years,Female,12882,1023,3150,2621,1289,3194,1605,4799,6088,41.4391006,-75.6121835
01/01/2012 12:00:00 AM,42069,Northeast,Lackawanna County WDA,Lackawanna,35,25 to 34 Years,Female,12247,945,3234,2304,1260,2990,1514,4504,5764,41.4391006,-75.6121835
01/01/2010 12:00:00 AM,42069,Northeast,Lackawanna County WDA,Lackawanna,35,25 to 34 Years,Female,11933,851,3639,2175,1267,2708,1293,4001,5268,41.4391006,-75.6121835
01/01/2012 12:00:00 AM,42069,Northeast,Lackawanna County WDA,Lackawanna,35,35 to 44 Years,Male,12902,907,5007,2162,1179,2410,1237,3647,4826,41.4391006,-75.6121835
01/01/2013 12:00:00 AM,42069,Northeast,Lackawanna County WDA,Lackawanna,35,35 to 44 Years,Male,12793,1058,4834,2141,1165,2363,1232,3595,4760,41.4391006,-75.6121835
01/01/2010 12:00:00 AM,42069,Northeast,Lackawanna County WDA,Lackawanna,35,35 to 44 Years,Male,13609,1064,5420,2258,1378,2263,1226,3489,4867,41.4391006,-75.6121835
01/01/2014 12:00:00 AM,42069,Northeast,Lackawanna County WDA,Lackawanna,35,35 to 44 Years,Male,12492,1045,4397,2167,1207,2508,1168,3676,4883,41.4391006,-75.6121835
01/01/2011 12:00:00 AM,42069,Northeast,Lackawanna County WDA,Lackawanna,35,35 to 44 Years,Male,13393,842,5541,2209,1328,2340,1133,3473,4801,41.4391006,-75.6121835
01/01/2015 12:00:00 AM,42069,Northeast,Lackawanna County WDA,Lackawanna,35,35 to 44 Years,Male,12223,1111,3997,2142,1267,2639,1067,3706,4973,41.4391006,-75.6121835
01/01/2016 12:00:00 AM,42069,Northeast,Lackawanna County WDA,Lackawanna,35,25 to 34 Years,Male,13205,1192,4388,2480,1139,2949,1057,4006,5145,41.4391006,-75.6121835
01/01/2016 12:00:00 AM,42069,Northeast,Lackawanna County WDA,Lackawanna,35,35 to 44 Years,Male,12015,1186,3829,2152,1267,2539,1042,3581,4848,41.4391006,-75.6121835
01/01/2015 12:00:00 AM,42069,Northeast,Lackawanna County WDA,Lackawanna,35,25 to 34 Years,Male,12968,1230,4428,2487,995,2884,944,3828,4823,41.4391006,-75.6121835
01/01/2013 12:00:00 AM,42069,Northeast,Lackawanna County WDA,Lackawanna,35,25 to 34 Years,Male,12467,1144,3886,2450,1019,3045,923,3968,4987,41.4391006,-75.6121835
01/01/2014 12:00:00 AM,42069,Northeast,Lackawanna County WDA,Lackawanna,35,25 to 34 Years,Male,12726,1111,4431,2454,1026,2786,918,3704,4730,41.4391006,-75.6121835
01/01/2012 12:00:00 AM,42069,Northeast,Lackawanna County WDA,Lackawanna,35,25 to 34 Years,Male,12279,1197,3880,2561,991,2857,793,3650,4641,41.4391006,-75.6121835
01/01/2011 12:00:00 AM,42069,Northeast,Lackawanna County WDA,Lackawanna,35,25 to 34 Years,Male,11981,1135,3481,2588,1106,2929,742,3671,4777,41.4391006,-75.6121835
01/01/2010 12:00:00 AM,42069,Northeast,Lackawanna County WDA,Lackawanna,35,25 to 34 Years,Male,11843,1332,3443,2439,1106,2849,674,3523,4629,41.4391006,-75.6121835
01/01/2015 12:00:00 AM,42023,Northwest,North Central WDA,Cameron,12,45 to 64 Years,Female,819,70,418,134,83,64,50,114,197,41.4388027,-78.2091693
01/01/2014 12:00:00 AM,42023,Northwest,North Central WDA,Cameron,12,45 to 64 Years,Female,837,62,440,113,75,106,41,147,222,41.4388027,-78.2091693
01/01/2013 12:00:00 AM,42023,Northwest,North Central WDA,Cameron,12,45 to 64 Years,Female,829,61,451,104,79,96,38,134,213,41.4388027,-78.2091693
01/01/2010 12:00:00 AM,42023,Northwest,North Central WDA,Cameron,12,45 to 64 Years,Male,844,82,449,124,69,82,38,120,189,41.4388027,-78.2091693
01/01/2016 12:00:00 AM,42023,Northwest,North Central WDA,Cameron,12,45 to 64 Years,Female,808,101,386,138,70,75,38,113,183,41.4388027,-78.2091693
01/01/2012 12:00:00 AM,42023,Northwest,North Central WDA,Cameron,12,45 to 64 Years,Female,835,76,453,93,65,111,37,148,213,41.4388027,-78.2091693
01/01/2010 12:00:00 AM,42023,Northwest,North Central WDA,Cameron,12,45 to 64 Years,Female,796,55,452,88,35,134,32,166,201,41.4388027,-78.2091693
01/01/2011 12:00:00 AM,42023,Northwest,North Central WDA,Cameron,12,45 to 64 Years,Female,821,56,470,101,45,122,27,149,194,41.4388027,-78.2091693
01/01/2011 12:00:00 AM,42023,Northwest,North Central WDA,Cameron,12,25 to 34 Years,Female,225,9,50,61,45,37,23,60,105,41.4388027,-78.2091693
01/01/2013 12:00:00 AM,42023,Northwest,North Central WDA,Cameron,12,25 to 34 Years,Female,222,13,39,73,43,32,22,54,97,41.4388027,-78.2091693
01/01/2011 12:00:00 AM,42023,Northwest,North Central WDA,Cameron,12,45 to 64 Years,Male,860,93,489,113,68,77,20,97,165,41.4388027,-78.2091693
01/01/2016 12:00:00 AM,42023,Northwest,North Central WDA,Cameron,12,35 to 44 Years,Female,230,33,71,35,30,43,18,61,91,41.4388027,-78.2091693
01/01/2010 12:00:00 AM,42023,Northwest,North Central WDA,Cameron,12,25 to 34 Years,Female,227,34,37,44,64,30,18,48,112,41.4388027,-78.2091693
01/01/2012 12:00:00 AM,42023,Northwest,North Central WDA,Cameron,12,25 to 34 Years,Female,225,8,49,71,46,34,17,51,97,41.4388027,-78.2091693
01/01/2016 12:00:00 AM,42023,Northwest,North Central WDA,Cameron,12,45 to 64 Years,Male,781,51,418,118,91,88,15,103,194,41.4388027,-78.2091693
01/01/2015 12:00:00 AM,42023,Northwest,North Central WDA,Cameron,12,45 to 64 Years,Male,823,55,437,122,89,106,14,120,209,41.4388027,-78.2091693
01/01/2015 12:00:00 AM,42023,Northwest,North Central WDA,Cameron,12,35 to 44 Years,Female,235,36,68,36,35,47,13,60,95,41.4388027,-78.2091693
01/01/2012 12:00:00 AM,42023,Northwest,North Central WDA,Cameron,12,45 to 64 Years,Male,857,98,498,69,74,107,11,118,192,41.4388027,-78.2091693
01/01/2010 12:00:00 AM,42023,Northwest,North Central WDA,Cameron,12,35 to 44 Years,Male,308,14,166,68,32,17,11,28,60,41.4388027,-78.2091693
01/01/2011 12:00:00 AM,42023,Northwest,North Central WDA,Cameron,12,35 to 44 Years,Male,290,18,179,49,19,15,10,25,44,41.4388027,-78.2091693
01/01/2010 12:00:00 AM,42023,Northwest,North Central WDA,Cameron,12,35 to 44 Years,Female,303,14,140,38,65,37,9,46,111,41.4388027,-78.2091693
01/01/2016 12:00:00 AM,42023,Northwest,North Central WDA,Cameron,12,25 to 34 Years,Female,198,8,54,56,29,43,8,51,80,41.4388027,-78.2091693
01/01/2014 12:00:00 AM,42023,Northwest,North Central WDA,Cameron,12,25 to 34 Years,Female,215,8,47,72,41,39,8,47,88,41.4388027,-78.2091693
01/01/2014 12:00:00 AM,42023,Northwest,North Central WDA,Cameron,12,35 to 44 Years,Female,239,30,102,27,36,36,8,44,80,41.4388027,-78.2091693
01/01/2015 12:00:00 AM,42023,Northwest,North Central WDA,Cameron,12,35 to 44 Years,Male,258,11,101,72,34,32,8,40,74,41.4388027,-78.2091693
01/01/2011 12:00:00 AM,42023,Northwest,North Central WDA,Cameron,12,35 to 44 Years,Female,281,21,135,36,55,26,8,34,89,41.4388027,-78.2091693
01/01/2013 12:00:00 AM,42023,Northwest,North Central WDA,Cameron,12,35 to 44 Years,Female,255,30,122,24,39,33,7,40,79,41.4388027,-78.2091693
01/01/2013 12:00:00 AM,42023,Northwest,North Central WDA,Cameron,12,45 to 64 Years,Male,846,100,482,67,86,105,6,111,197,41.4388027,-78.2091693
01/01/2014 12:00:00 AM,42023,Northwest,North Central WDA,Cameron,12,45 to 64 Years,Male,846,85,473,105,79,98,6,104,183,41.4388027,-78.2091693
01/01/2015 12:00:00 AM,42023,Northwest,North Central WDA,Cameron,12,25 to 34 Years,Female,202,3,49,74,32,38,6,44,76,41.4388027,-78.2091693
01/01/2016 12:00:00 AM,42023,Northwest,North Central WDA,Cameron,12,35 to 44 Years,Male,246,10,72,77,44,37,6,43,87,41.4388027,-78.2091693
01/01/2014 12:00:00 AM,42023,Northwest,North Central WDA,Cameron,12,35 to 44 Years,Male,266,13,134,73,9,31,6,37,46,41.4388027,-78.2091693
01/01/2013 12:00:00 AM,42023,Northwest,North Central WDA,Cameron,12,35 to 44 Years,Male,275,17,152,62,9,31,4,35,44,41.4388027,-78.2091693
01/01/2012 12:00:00 AM,42023,Northwest,North Central WDA,Cameron,12,35 to 44 Years,Female,268,18,125,39,52,31,3,34,86,41.4388027,-78.2091693
01/01/2012 12:00:00 AM,42023,Northwest,North Central WDA,Cameron,12,35 to 44 Years,Male,286,24,169,55,6,29,3,32,38,41.4388027,-78.2091693
01/01/2016 12:00:00 AM,42023,Northwest,North Central WDA,Cameron,12,25 to 34 Years,Male,226,19,86,30,17,74,0,74,91,41.4388027,-78.2091693
01/01/2015 12:00:00 AM,42023,Northwest,North Central WDA,Cameron,12,25 to 34 Years,Male,218,22,84,28,19,65,0,65,84,41.4388027,-78.2091693
01/01/2014 12:00:00 AM,42023,Northwest,North Central WDA,Cameron,12,25 to 34 Years,Male,221,21,96,41,19,44,0,44,63,41.4388027,-78.2091693
01/01/2010 12:00:00 AM,42023,Northwest,North Central WDA,Cameron,12,25 to 34 Years,Male,245,43,109,43,15,35,0,35,50,41.4388027,-78.2091693
01/01/2011 12:00:00 AM,42023,Northwest,North Central WDA,Cameron,12,25 to 34 Years,Male,243,39,112,46,14,32,0,32,46,41.4388027,-78.2091693
01/01/2013 12:00:00 AM,42023,Northwest,North Central WDA,Cameron,12,25 to 34 Years,Male,224,34,61,58,26,45,0,45,71,41.4388027,-78.2091693
01/01/2012 12:00:00 AM,42023,Northwest,North Central WDA,Cameron,12,25 to 34 Years,Male,227,33,83,46,25,40,0,40,65,41.4388027,-78.2091693
01/01/2015 12:00:00 AM,42047,Northwest,North Central WDA,Elk,24,45 to 64 Years,Female,4870,218,2364,729,650,567,342,909,1559,41.4281942,-78.6494771
01/01/2011 12:00:00 AM,42047,Northwest,North Central WDA,Elk,24,45 to 64 Years,Female,4773,192,2792,692,321,445,331,776,1097,41.4281942,-78.6494771
01/01/2016 12:00:00 AM,42047,Northwest,North Central WDA,Elk,24,45 to 64 Years,Female,4802,229,2193,771,657,631,321,952,1609,41.4281942,-78.6494771
01/01/2012 12:00:00 AM,42047,Northwest,North Central WDA,Elk,24,45 to 64 Years,Male,5092,303,2816,623,567,469,314,783,1350,41.4281942,-78.6494771
01/01/2013 12:00:00 AM,42047,Northwest,North Central WDA,Elk,24,45 to 64 Years,Female,4874,160,2630,773,542,455,314,769,1311,41.4281942,-78.6494771
01/01/2014 12:00:00 AM,42047,Northwest,North Central WDA,Elk,24,45 to 64 Years,Female,4882,195,2484,721,696,479,307,786,1482,41.4281942,-78.6494771
01/01/2010 12:00:00 AM,42047,Northwest,North Central WDA,Elk,24,45 to 64 Years,Female,4696,235,2785,694,284,392,306,698,982,41.4281942,-78.6494771
01/01/2011 12:00:00 AM,42047,Northwest,North Central WDA,Elk,24,45 to 64 Years,Male,5024,335,2698,676,554,469,292,761,1315,41.4281942,-78.6494771
01/01/2012 12:00:00 AM,42047,Northwest,North Central WDA,Elk,24,45 to 64 Years,Female,4847,135,2727,735,458,502,290,792,1250,41.4281942,-78.6494771
01/01/2010 12:00:00 AM,42047,Northwest,North Central WDA,Elk,24,45 to 64 Years,Male,4946,278,2664,638,610,479,277,756,1366,41.4281942,-78.6494771
01/01/2013 12:00:00 AM,42047,Northwest,North Central WDA,Elk,24,45 to 64 Years,Male,5139,349,2888,683,558,410,251,661,1219,41.4281942,-78.6494771
01/01/2015 12:00:00 AM,42047,Northwest,North Central WDA,Elk,24,45 to 64 Years,Male,5127,296,2764,663,609,546,249,795,1404,41.4281942,-78.6494771
01/01/2016 12:00:00 AM,42047,Northwest,North Central WDA,Elk,24,45 to 64 Years,Male,5088,273,2671,661,613,635,235,870,1483,41.4281942,-78.6494771
01/01/2014 12:00:00 AM,42047,Northwest,North Central WDA,Elk,24,45 to 64 Years,Male,5153,351,2878,697,506,495,226,721,1227,41.4281942,-78.6494771
01/01/2016 12:00:00 AM,42047,Northwest,North Central WDA,Elk,24,35 to 44 Years,Female,1754,70,451,309,327,416,181,597,924,41.4281942,-78.6494771
01/01/2016 12:00:00 AM,42047,Northwest,North Central WDA,Elk,24,25 to 34 Years,Female,1388,23,478,273,223,251,140,391,614,41.4281942,-78.6494771
01/01/2014 12:00:00 AM,42047,Northwest,North Central WDA,Elk,24,35 to 44 Years,Female,1916,59,747,320,325,335,130,465,790,41.4281942,-78.6494771
01/01/2013 12:00:00 AM,42047,Northwest,North Central WDA,Elk,24,35 to 44 Years,Female,2026,82,803,358,345,318,120,438,783,41.4281942,-78.6494771
01/01/2015 12:00:00 AM,42047,Northwest,North Central WDA,Elk,24,35 to 44 Years,Female,1830,79,622,315,335,364,115,479,814,41.4281942,-78.6494771
01/01/2012 12:00:00 AM,42047,Northwest,North Central WDA,Elk,24,35 to 44 Years,Female,2101,57,920,351,366,293,114,407,773,41.4281942,-78.6494771
01/01/2010 12:00:00 AM,42047,Northwest,North Central WDA,Elk,24,35 to 44 Years,Female,2249,71,966,385,361,353,113,466,827,41.4281942,-78.6494771
01/01/2015 12:00:00 AM,42047,Northwest,North Central WDA,Elk,24,35 to 44 Years,Male,1827,114,831,280,255,240,107,347,602,41.4281942,-78.6494771
01/01/2015 12:00:00 AM,42047,Northwest,North Central WDA,Elk,24,25 to 34 Years,Female,1415,32,599,298,164,223,99,322,486,41.4281942,-78.6494771
01/01/2011 12:00:00 AM,42047,Northwest,North Central WDA,Elk,24,35 to 44 Years,Female,2174,93,958,393,347,285,98,383,730,41.4281942,-78.6494771
01/01/2014 12:00:00 AM,42047,Northwest,North Central WDA,Elk,24,25 to 34 Years,Female,1433,68,628,295,142,220,80,300,442,41.4281942,-78.6494771
01/01/2016 12:00:00 AM,42047,Northwest,North Central WDA,Elk,24,35 to 44 Years,Male,1732,97,805,267,253,231,79,310,563,41.4281942,-78.6494771
01/01/2013 12:00:00 AM,42047,Northwest,North Central WDA,Elk,24,25 to 34 Years,Female,1451,87,595,318,135,241,75,316,451,41.4281942,-78.6494771
01/01/2016 12:00:00 AM,42047,Northwest,North Central WDA,Elk,24,25 to 34 Years,Male,1608,84,810,221,168,253,72,325,493,41.4281942,-78.6494771
01/01/2010 12:00:00 AM,42047,Northwest,North Central WDA,Elk,24,35 to 44 Years,Male,2365,215,902,391,320,468,69,537,857,41.4281942,-78.6494771
01/01/2014 12:00:00 AM,42047,Northwest,North Central WDA,Elk,24,35 to 44 Years,Male,1989,94,760,442,300,326,67,393,693,41.4281942,-78.6494771
01/01/2014 12:00:00 AM,42047,Northwest,North Central WDA,Elk,24,25 to 34 Years,Male,1612,92,799,212,186,260,63,323,509,41.4281942,-78.6494771
01/01/2015 12:00:00 AM,42047,Northwest,North Central WDA,Elk,24,25 to 34 Years,Male,1593,91,767,201,187,285,62,347,534,41.4281942,-78.6494771
01/01/2010 12:00:00 AM,42047,Northwest,North Central WDA,Elk,24,25 to 34 Years,Female,1562,95,634,158,230,384,61,445,675,41.4281942,-78.6494771
01/01/2013 12:00:00 AM,42047,Northwest,North Central WDA,Elk,24,35 to 44 Years,Male,2082,121,803,474,309,335,40,375,684,41.4281942,-78.6494771
01/01/2012 12:00:00 AM,42047,Northwest,North Central WDA,Elk,24,35 to 44 Years,Male,2201,153,870,426,308,405,39,444,752,41.4281942,-78.6494771
01/01/2011 12:00:00 AM,42047,Northwest,North Central WDA,Elk,24,25 to 34 Years,Female,1537,107,705,255,155,276,39,315,470,41.4281942,-78.6494771
01/01/2011 12:00:00 AM,42047,Northwest,North Central WDA,Elk,24,35 to 44 Years,Male,2316,230,846,468,288,448,36,484,772,41.4281942,-78.6494771
01/01/2012 12:00:00 AM,42047,Northwest,North Central WDA,Elk,24,25 to 34 Years,Female,1487,85,651,299,138,279,35,314,452,41.4281942,-78.6494771
01/01/2013 12:00:00 AM,42047,Northwest,North Central WDA,Elk,24,25 to 34 Years,Male,1547,61,798,207,199,258,24,282,481,41.4281942,-78.6494771
01/01/2010 12:00:00 AM,42047,Northwest,North Central WDA,Elk,24,25 to 34 Years,Male,1546,50,710,330,174,266,16,282,456,41.4281942,-78.6494771
01/01/2011 12:00:00 AM,42047,Northwest,North Central WDA,Elk,24,25 to 34 Years,Male,1563,49,742,280,199,287,6,293,492,41.4281942,-78.6494771
01/01/2012 12:00:00 AM,42047,Northwest,North Central WDA,Elk,24,25 to 34 Years,Male,1547,54,716,269,216,286,6,292,508,41.4281942,-78.6494771
01/01/2010 12:00:00 AM,42121,Northwest,Northwest WDA,Venango,61,45 to 64 Years,Female,8557,544,4447,1383,876,743,564,1307,2183,41.4034126,-79.7628656
01/01/2011 12:00:00 AM,42121,Northwest,Northwest WDA,Venango,61,45 to 64 Years,Female,8648,638,4474,1338,931,729,538,1267,2198,41.4034126,-79.7628656
01/01/2016 12:00:00 AM,42121,Northwest,Northwest WDA,Venango,61,45 to 64 Years,Female,8354,720,4096,1358,762,936,482,1418,2180,41.4034126,-79.7628656
01/01/2012 12:00:00 AM,42121,Northwest,Northwest WDA,Venango,61,45 to 64 Years,Female,8596,612,4318,1476,977,742,471,1213,2190,41.4034126,-79.7628656
01/01/2013 12:00:00 AM,42121,Northwest,Northwest WDA,Venango,61,45 to 64 Years,Female,8590,637,4297,1493,884,832,447,1279,2163,41.4034126,-79.7628656
01/01/2015 12:00:00 AM,42121,Northwest,Northwest WDA,Venango,61,45 to 64 Years,Female,8462,670,4226,1415,855,860,436,1296,2151,41.4034126,-79.7628656
01/01/2010 12:00:00 AM,42121,Northwest,Northwest WDA,Venango,61,45 to 64 Years,Male,8399,897,4481,1199,579,811,432,1243,1822,41.4034126,-79.7628656
01/01/2014 12:00:00 AM,42121,Northwest,Northwest WDA,Venango,61,45 to 64 Years,Female,8527,651,4234,1465,908,844,425,1269,2177,41.4034126,-79.7628656
01/01/2011 12:00:00 AM,42121,Northwest,Northwest WDA,Venango,61,45 to 64 Years,Male,8385,900,4380,1181,597,913,414,1327,1924,41.4034126,-79.7628656
01/01/2012 12:00:00 AM,42121,Northwest,Northwest WDA,Venango,61,45 to 64 Years,Male,8462,818,4510,1233,614,896,391,1287,1901,41.4034126,-79.7628656
01/01/2013 12:00:00 AM,42121,Northwest,Northwest WDA,Venango,61,45 to 64 Years,Male,8445,724,4579,1137,668,970,367,1337,2005,41.4034126,-79.7628656
01/01/2016 12:00:00 AM,42121,Northwest,Northwest WDA,Venango,61,45 to 64 Years,Male,8218,802,4365,1124,657,926,344,1270,1927,41.4034126,-79.7628656
01/01/2016 12:00:00 AM,42121,Northwest,Northwest WDA,Venango,61,35 to 44 Years,Female,2922,204,1128,455,393,425,317,742,1135,41.4034126,-79.7628656
01/01/2015 12:00:00 AM,42121,Northwest,Northwest WDA,Venango,61,45 to 64 Years,Male,8352,802,4518,1133,711,902,286,1188,1899,41.4034126,-79.7628656
01/01/2014 12:00:00 AM,42121,Northwest,Northwest WDA,Venango,61,45 to 64 Years,Male,8414,790,4505,1105,706,1027,281,1308,2014,41.4034126,-79.7628656
01/01/2012 12:00:00 AM,42121,Northwest,Northwest WDA,Venango,61,35 to 44 Years,Female,3242,202,1287,479,431,590,253,843,1274,41.4034126,-79.7628656
01/01/2014 12:00:00 AM,42121,Northwest,Northwest WDA,Venango,61,35 to 44 Years,Female,3075,230,1193,396,484,523,249,772,1256,41.4034126,-79.7628656
01/01/2015 12:00:00 AM,42121,Northwest,Northwest WDA,Venango,61,35 to 44 Years,Female,2977,201,1140,477,428,485,246,731,1159,41.4034126,-79.7628656
01/01/2013 12:00:00 AM,42121,Northwest,Northwest WDA,Venango,61,35 to 44 Years,Female,3145,246,1182,447,447,580,243,823,1270,41.4034126,-79.7628656
01/01/2015 12:00:00 AM,42121,Northwest,Northwest WDA,Venango,61,25 to 34 Years,Female,2824,182,1050,556,301,508,227,735,1036,41.4034126,-79.7628656
01/01/2014 12:00:00 AM,42121,Northwest,Northwest WDA,Venango,61,25 to 34 Years,Female,2854,159,1139,557,302,483,214,697,999,41.4034126,-79.7628656
01/01/2013 12:00:00 AM,42121,Northwest,Northwest WDA,Venango,61,25 to 34 Years,Female,2842,181,1099,664,260,426,212,638,898,41.4034126,-79.7628656
01/01/2011 12:00:00 AM,42121,Northwest,Northwest WDA,Venango,61,35 to 44 Years,Female,3302,214,1396,471,456,563,202,765,1221,41.4034126,-79.7628656
01/01/2010 12:00:00 AM,42121,Northwest,Northwest WDA,Venango,61,35 to 44 Years,Female,3395,236,1500,566,451,444,198,642,1093,41.4034126,-79.7628656
01/01/2012 12:00:00 AM,42121,Northwest,Northwest WDA,Venango,61,25 to 34 Years,Female,2799,161,1049,687,310,404,188,592,902,41.4034126,-79.7628656
01/01/2016 12:00:00 AM,42121,Northwest,Northwest WDA,Venango,61,25 to 34 Years,Female,2784,167,1028,574,369,463,183,646,1015,41.4034126,-79.7628656
01/01/2014 12:00:00 AM,42121,Northwest,Northwest WDA,Venango,61,35 to 44 Years,Male,3122,177,1517,455,385,425,163,588,973,41.4034126,-79.7628656
01/01/2012 12:00:00 AM,42121,Northwest,Northwest WDA,Venango,61,35 to 44 Years,Male,3233,181,1453,594,396,455,154,609,1005,41.4034126,-79.7628656
01/01/2013 12:00:00 AM,42121,Northwest,Northwest WDA,Venango,61,35 to 44 Years,Male,3178,147,1494,519,397,469,152,621,1018,41.4034126,-79.7628656
01/01/2016 12:00:00 AM,42121,Northwest,Northwest WDA,Venango,61,35 to 44 Years,Male,2983,181,1485,532,246,389,150,539,785,41.4034126,-79.7628656
01/01/2015 12:00:00 AM,42121,Northwest,Northwest WDA,Venango,61,35 to 44 Years,Male,3054,154,1557,494,300,414,135,549,849,41.4034126,-79.7628656
01/01/2011 12:00:00 AM,42121,Northwest,Northwest WDA,Venango,61,25 to 34 Years,Female,2834,253,1031,669,337,421,123,544,881,41.4034126,-79.7628656
01/01/2010 12:00:00 AM,42121,Northwest,Northwest WDA,Venango,61,35 to 44 Years,Male,3412,223,1670,585,386,428,120,548,934,41.4034126,-79.7628656
01/01/2011 12:00:00 AM,42121,Northwest,Northwest WDA,Venango,61,35 to 44 Years,Male,3323,205,1494,613,387,521,103,624,1011,41.4034126,-79.7628656
01/01/2010 12:00:00 AM,42121,Northwest,Northwest WDA,Venango,61,25 to 34 Years,Female,2845,305,1014,587,453,383,103,486,939,41.4034126,-79.7628656
01/01/2015 12:00:00 AM,42121,Northwest,Northwest WDA,Venango,61,25 to 34 Years,Male,2685,286,1200,429,397,289,84,373,770,41.4034126,-79.7628656
01/01/2016 12:00:00 AM,42121,Northwest,Northwest WDA,Venango,61,25 to 34 Years,Male,2683,273,1250,430,371,285,74,359,730,41.4034126,-79.7628656
01/01/2014 12:00:00 AM,42121,Northwest,Northwest WDA,Venango,61,25 to 34 Years,Male,2722,269,1133,505,429,333,53,386,815,41.4034126,-79.7628656
01/01/2012 12:00:00 AM,42121,Northwest,Northwest WDA,Venango,61,25 to 34 Years,Male,2758,302,1122,517,452,320,45,365,817,41.4034126,-79.7628656
01/01/2013 12:00:00 AM,42121,Northwest,Northwest WDA,Venango,61,25 to 34 Years,Male,2748,308,1164,498,441,297,40,337,778,41.4034126,-79.7628656
01/01/2011 12:00:00 AM,42121,Northwest,Northwest WDA,Venango,61,25 to 34 Years,Male,2781,257,1101,587,501,300,35,335,836,41.4034126,-79.7628656
01/01/2010 12:00:00 AM,42121,Northwest,Northwest WDA,Venango,61,25 to 34 Years,Male,2794,231,1209,498,489,347,20,367,856,41.4034126,-79.7628656
01/01/2015 12:00:00 AM,42081,Northeast,Central WDA,Lycoming,41,45 to 64 Years,Female,16746,1368,7345,2868,1953,1857,1355,3212,5165,41.3445979,-77.0694246
01/01/2014 12:00:00 AM,42081,Northeast,Central WDA,Lycoming,41,45 to 64 Years,Male,16306,1788,6754,2871,1639,1910,1344,3254,4893,41.3445979,-77.0694246
01/01/2014 12:00:00 AM,42081,Northeast,Central WDA,Lycoming,41,45 to 64 Years,Female,16869,1354,7416,2814,2054,1891,1340,3231,5285,41.3445979,-77.0694246
01/01/2012 12:00:00 AM,42081,Northeast,Central WDA,Lycoming,41,45 to 64 Years,Female,16866,1501,7437,2700,1976,1917,1335,3252,5228,41.3445979,-77.0694246
01/01/2015 12:00:00 AM,42081,Northeast,Central WDA,Lycoming,41,45 to 64 Years,Male,16149,1739,6703,2738,1763,1875,1331,3206,4969,41.3445979,-77.0694246
01/01/2012 12:00:00 AM,42081,Northeast,Central WDA,Lycoming,41,45 to 64 Years,Male,16425,1722,6917,2838,1651,1984,1313,3297,4948,41.3445979,-77.0694246
01/01/2013 12:00:00 AM,42081,Northeast,Central WDA,Lycoming,41,45 to 64 Years,Female,16899,1471,7465,2845,2006,1813,1299,3112,5118,41.3445979,-77.0694246
01/01/2011 12:00:00 AM,42081,Northeast,Central WDA,Lycoming,41,45 to 64 Years,Male,16294,1681,6795,2721,1789,2037,1271,3308,5097,41.3445979,-77.0694246
01/01/2016 12:00:00 AM,42081,Northeast,Central WDA,Lycoming,41,45 to 64 Years,Female,16583,1211,7199,2997,2041,1872,1263,3135,5176,41.3445979,-77.0694246
01/01/2013 12:00:00 AM,42081,Northeast,Central WDA,Lycoming,41,45 to 64 Years,Male,16444,1767,6972,2769,1634,2041,1261,3302,4936,41.3445979,-77.0694246
01/01/2010 12:00:00 AM,42081,Northeast,Central WDA,Lycoming,41,45 to 64 Years,Female,16660,1768,7281,2642,1851,1897,1221,3118,4969,41.3445979,-77.0694246
01/01/2016 12:00:00 AM,42081,Northeast,Central WDA,Lycoming,41,45 to 64 Years,Male,15895,1696,6507,2959,1744,1770,1219,2989,4733,41.3445979,-77.0694246
01/01/2011 12:00:00 AM,42081,Northeast,Central WDA,Lycoming,41,45 to 64 Years,Female,16827,1782,7323,2699,1944,1873,1206,3079,5023,41.3445979,-77.0694246
01/01/2010 12:00:00 AM,42081,Northeast,Central WDA,Lycoming,41,45 to 64 Years,Male,16034,1756,6547,2796,1847,2016,1072,3088,4935,41.3445979,-77.0694246
01/01/2015 12:00:00 AM,42081,Northeast,Central WDA,Lycoming,41,35 to 44 Years,Female,6812,388,2095,1183,1226,1196,724,1920,3146,41.3445979,-77.0694246
01/01/2016 12:00:00 AM,42081,Northeast,Central WDA,Lycoming,41,35 to 44 Years,Female,6661,407,2018,1176,1195,1153,712,1865,3060,41.3445979,-77.0694246
01/01/2015 12:00:00 AM,42081,Northeast,Central WDA,Lycoming,41,25 to 34 Years,Female,7246,727,1972,1384,894,1599,670,2269,3163,41.3445979,-77.0694246
01/01/2016 12:00:00 AM,42081,Northeast,Central WDA,Lycoming,41,25 to 34 Years,Female,7272,665,1916,1541,874,1624,652,2276,3150,41.3445979,-77.0694246
01/01/2011 12:00:00 AM,42081,Northeast,Central WDA,Lycoming,41,35 to 44 Years,Female,7471,716,2727,1207,1051,1131,639,1770,2821,41.3445979,-77.0694246
01/01/2013 12:00:00 AM,42081,Northeast,Central WDA,Lycoming,41,35 to 44 Years,Female,7091,500,2421,1169,1194,1189,618,1807,3001,41.3445979,-77.0694246
01/01/2014 12:00:00 AM,42081,Northeast,Central WDA,Lycoming,41,35 to 44 Years,Female,6888,526,2281,1174,1174,1129,604,1733,2907,41.3445979,-77.0694246
01/01/2012 12:00:00 AM,42081,Northeast,Central WDA,Lycoming,41,35 to 44 Years,Female,7348,592,2583,1314,1182,1077,600,1677,2859,41.3445979,-77.0694246
01/01/2014 12:00:00 AM,42081,Northeast,Central WDA,Lycoming,41,25 to 34 Years,Female,7071,681,2114,1377,892,1420,587,2007,2899,41.3445979,-77.0694246
01/01/2010 12:00:00 AM,42081,Northeast,Central WDA,Lycoming,41,35 to 44 Years,Female,7634,829,2910,1187,1097,1032,579,1611,2708,41.3445979,-77.0694246
01/01/2013 12:00:00 AM,42081,Northeast,Central WDA,Lycoming,41,25 to 34 Years,Female,6884,659,2138,1373,822,1362,530,1892,2714,41.3445979,-77.0694246
01/01/2012 12:00:00 AM,42081,Northeast,Central WDA,Lycoming,41,25 to 34 Years,Female,6627,641,1991,1389,880,1272,454,1726,2606,41.3445979,-77.0694246
01/01/2015 12:00:00 AM,42081,Northeast,Central WDA,Lycoming,41,35 to 44 Years,Male,6480,634,2651,1016,786,952,441,1393,2179,41.3445979,-77.0694246
01/01/2010 12:00:00 AM,42081,Northeast,Central WDA,Lycoming,41,25 to 34 Years,Female,6417,520,1972,1354,776,1356,439,1795,2571,41.3445979,-77.0694246
01/01/2016 12:00:00 AM,42081,Northeast,Central WDA,Lycoming,41,35 to 44 Years,Male,6420,525,2668,1087,771,940,429,1369,2140,41.3445979,-77.0694246
01/01/2014 12:00:00 AM,42081,Northeast,Central WDA,Lycoming,41,35 to 44 Years,Male,6502,534,2843,1064,858,777,426,1203,2061,41.3445979,-77.0694246
01/01/2010 12:00:00 AM,42081,Northeast,Central WDA,Lycoming,41,35 to 44 Years,Male,7147,864,2706,1272,924,962,419,1381,2305,41.3445979,-77.0694246
01/01/2011 12:00:00 AM,42081,Northeast,Central WDA,Lycoming,41,35 to 44 Years,Male,6944,851,2696,1239,885,890,383,1273,2158,41.3445979,-77.0694246
01/01/2011 12:00:00 AM,42081,Northeast,Central WDA,Lycoming,41,25 to 34 Years,Female,6546,709,1992,1269,823,1371,382,1753,2576,41.3445979,-77.0694246
01/01/2013 12:00:00 AM,42081,Northeast,Central WDA,Lycoming,41,35 to 44 Years,Male,6593,511,2924,1182,843,755,378,1133,1976,41.3445979,-77.0694246
01/01/2012 12:00:00 AM,42081,Northeast,Central WDA,Lycoming,41,35 to 44 Years,Male,6723,642,2866,1232,851,770,362,1132,1983,41.3445979,-77.0694246
01/01/2016 12:00:00 AM,42081,Northeast,Central WDA,Lycoming,41,25 to 34 Years,Male,7361,800,2471,1454,691,1633,312,1945,2636,41.3445979,-77.0694246
01/01/2015 12:00:00 AM,42081,Northeast,Central WDA,Lycoming,41,25 to 34 Years,Male,7098,869,2637,1244,627,1484,237,1721,2348,41.3445979,-77.0694246
01/01/2010 12:00:00 AM,42081,Northeast,Central WDA,Lycoming,41,25 to 34 Years,Male,6358,620,2177,1409,746,1189,217,1406,2152,41.3445979,-77.0694246
01/01/2014 12:00:00 AM,42081,Northeast,Central WDA,Lycoming,41,25 to 34 Years,Male,6919,811,2580,1267,713,1339,209,1548,2261,41.3445979,-77.0694246
01/01/2012 12:00:00 AM,42081,Northeast,Central WDA,Lycoming,41,25 to 34 Years,Male,6382,597,2471,1303,723,1088,200,1288,2011,41.3445979,-77.0694246
01/01/2011 12:00:00 AM,42081,Northeast,Central WDA,Lycoming,41,25 to 34 Years,Male,6260,593,2408,1295,691,1077,196,1273,1964,41.3445979,-77.0694246
01/01/2013 12:00:00 AM,42081,Northeast,Central WDA,Lycoming,41,25 to 34 Years,Male,6643,652,2653,1309,710,1167,152,1319,2029,41.3445979,-77.0694246
01/01/2016 12:00:00 AM,42103,Northeast,Pocono Counties WDA,Pike,52,45 to 64 Years,Female,9004,738,2996,1997,919,1352,1002,2354,3273,41.332572,-75.0327092
01/01/2013 12:00:00 AM,42103,Northeast,Pocono Counties WDA,Pike,52,45 to 64 Years,Female,9201,497,3254,2430,778,1260,982,2242,3020,41.332572,-75.0327092
01/01/2014 12:00:00 AM,42103,Northeast,Pocono Counties WDA,Pike,52,45 to 64 Years,Female,9148,513,3200,2397,869,1198,971,2169,3038,41.332572,-75.0327092
01/01/2015 12:00:00 AM,42103,Northeast,Pocono Counties WDA,Pike,52,45 to 64 Years,Female,9102,598,3149,2278,867,1307,903,2210,3077,41.332572,-75.0327092
01/01/2010 12:00:00 AM,42103,Northeast,Pocono Counties WDA,Pike,52,45 to 64 Years,Female,8729,368,3308,2003,768,1390,892,2282,3050,41.332572,-75.0327092
01/01/2011 12:00:00 AM,42103,Northeast,Pocono Counties WDA,Pike,52,45 to 64 Years,Female,8844,329,3358,2287,769,1219,882,2101,2870,41.332572,-75.0327092
01/01/2011 12:00:00 AM,42103,Northeast,Pocono Counties WDA,Pike,52,45 to 64 Years,Male,8762,676,3269,1963,674,1332,848,2180,2854,41.332572,-75.0327092
01/01/2012 12:00:00 AM,42103,Northeast,Pocono Counties WDA,Pike,52,45 to 64 Years,Female,9122,375,3153,2639,837,1274,844,2118,2955,41.332572,-75.0327092
01/01/2012 12:00:00 AM,42103,Northeast,Pocono Counties WDA,Pike,52,45 to 64 Years,Male,8945,664,3340,2237,591,1290,823,2113,2704,41.332572,-75.0327092
01/01/2010 12:00:00 AM,42103,Northeast,Pocono Counties WDA,Pike,52,45 to 64 Years,Male,8528,682,3342,1836,588,1269,811,2080,2668,41.332572,-75.0327092
01/01/2016 12:00:00 AM,42103,Northeast,Pocono Counties WDA,Pike,52,45 to 64 Years,Male,8885,838,3357,2024,622,1242,802,2044,2666,41.332572,-75.0327092
01/01/2015 12:00:00 AM,42103,Northeast,Pocono Counties WDA,Pike,52,45 to 64 Years,Male,8920,827,3410,2131,559,1195,798,1993,2552,41.332572,-75.0327092
01/01/2013 12:00:00 AM,42103,Northeast,Pocono Counties WDA,Pike,52,45 to 64 Years,Male,9045,631,3634,2228,489,1275,788,2063,2552,41.332572,-75.0327092
01/01/2014 12:00:00 AM,42103,Northeast,Pocono Counties WDA,Pike,52,45 to 64 Years,Male,8941,817,3592,2132,508,1168,724,1892,2400,41.332572,-75.0327092
01/01/2016 12:00:00 AM,42103,Northeast,Pocono Counties WDA,Pike,52,35 to 44 Years,Female,3301,130,931,750,395,707,388,1095,1490,41.332572,-75.0327092
01/01/2015 12:00:00 AM,42103,Northeast,Pocono Counties WDA,Pike,52,35 to 44 Years,Female,3479,106,1018,795,446,743,371,1114,1560,41.332572,-75.0327092
01/01/2011 12:00:00 AM,42103,Northeast,Pocono Counties WDA,Pike,52,35 to 44 Years,Female,4123,88,1294,972,576,861,332,1193,1769,41.332572,-75.0327092
01/01/2012 12:00:00 AM,42103,Northeast,Pocono Counties WDA,Pike,52,35 to 44 Years,Female,3925,57,1200,1028,559,749,332,1081,1640,41.332572,-75.0327092
01/01/2014 12:00:00 AM,42103,Northeast,Pocono Counties WDA,Pike,52,35 to 44 Years,Female,3599,112,1019,935,460,741,332,1073,1533,41.332572,-75.0327092
01/01/2010 12:00:00 AM,42103,Northeast,Pocono Counties WDA,Pike,52,35 to 44 Years,Female,4231,133,1563,902,532,812,289,1101,1633,41.332572,-75.0327092
01/01/2013 12:00:00 AM,42103,Northeast,Pocono Counties WDA,Pike,52,35 to 44 Years,Female,3693,67,1039,1077,600,632,278,910,1510,41.332572,-75.0327092
01/01/2016 12:00:00 AM,42103,Northeast,Pocono Counties WDA,Pike,52,25 to 34 Years,Female,2394,130,431,670,171,793,199,992,1163,41.332572,-75.0327092
01/01/2015 12:00:00 AM,42103,Northeast,Pocono Counties WDA,Pike,52,25 to 34 Years,Female,2261,98,447,631,195,698,192,890,1085,41.332572,-75.0327092
01/01/2014 12:00:00 AM,42103,Northeast,Pocono Counties WDA,Pike,52,25 to 34 Years,Female,2300,112,583,597,212,604,192,796,1008,41.332572,-75.0327092
01/01/2011 12:00:00 AM,42103,Northeast,Pocono Counties WDA,Pike,52,25 to 34 Years,Female,2620,156,723,717,340,508,176,684,1024,41.332572,-75.0327092
01/01/2013 12:00:00 AM,42103,Northeast,Pocono Counties WDA,Pike,52,25 to 34 Years,Female,2422,101,687,706,287,465,176,641,928,41.332572,-75.0327092
01/01/2012 12:00:00 AM,42103,Northeast,Pocono Counties WDA,Pike,52,25 to 34 Years,Female,2499,169,618,748,260,554,150,704,964,41.332572,-75.0327092
01/01/2016 12:00:00 AM,42103,Northeast,Pocono Counties WDA,Pike,52,35 to 44 Years,Male,3112,265,1232,667,315,498,135,633,948,41.332572,-75.0327092
01/01/2010 12:00:00 AM,42103,Northeast,Pocono Counties WDA,Pike,52,25 to 34 Years,Female,2641,138,790,731,319,529,134,663,982,41.332572,-75.0327092
01/01/2011 12:00:00 AM,42103,Northeast,Pocono Counties WDA,Pike,52,25 to 34 Years,Male,2434,219,972,478,271,363,131,494,765,41.332572,-75.0327092
01/01/2011 12:00:00 AM,42103,Northeast,Pocono Counties WDA,Pike,52,35 to 44 Years,Male,3905,251,1716,999,292,524,123,647,939,41.332572,-75.0327092
01/01/2014 12:00:00 AM,42103,Northeast,Pocono Counties WDA,Pike,52,25 to 34 Years,Male,2348,258,865,556,234,312,123,435,669,41.332572,-75.0327092
01/01/2015 12:00:00 AM,42103,Northeast,Pocono Counties WDA,Pike,52,35 to 44 Years,Male,3239,223,1333,736,289,538,120,658,947,41.332572,-75.0327092
01/01/2010 12:00:00 AM,42103,Northeast,Pocono Counties WDA,Pike,52,35 to 44 Years,Male,4115,315,1892,943,263,585,117,702,965,41.332572,-75.0327092
01/01/2012 12:00:00 AM,42103,Northeast,Pocono Counties WDA,Pike,52,25 to 34 Years,Male,2397,320,907,465,298,296,111,407,705,41.332572,-75.0327092
01/01/2013 12:00:00 AM,42103,Northeast,Pocono Counties WDA,Pike,52,25 to 34 Years,Male,2446,301,932,488,269,347,109,456,725,41.332572,-75.0327092
01/01/2012 12:00:00 AM,42103,Northeast,Pocono Counties WDA,Pike,52,35 to 44 Years,Male,3624,224,1690,810,360,444,96,540,900,41.332572,-75.0327092
01/01/2010 12:00:00 AM,42103,Northeast,Pocono Counties WDA,Pike,52,25 to 34 Years,Male,2407,292,911,497,260,356,91,447,707,41.332572,-75.0327092
01/01/2013 12:00:00 AM,42103,Northeast,Pocono Counties WDA,Pike,52,35 to 44 Years,Male,3349,311,1482,695,371,404,86,490,861,41.332572,-75.0327092
01/01/2015 12:00:00 AM,42103,Northeast,Pocono Counties WDA,Pike,52,25 to 34 Years,Male,2291,181,801,677,190,357,85,442,632,41.332572,-75.0327092
01/01/2014 12:00:00 AM,42103,Northeast,Pocono Counties WDA,Pike,52,35 to 44 Years,Male,3362,286,1470,705,344,474,83,557,901,41.332572,-75.0327092
01/01/2016 12:00:00 AM,42103,Northeast,Pocono Counties WDA,Pike,52,25 to 34 Years,Male,2408,166,747,859,144,413,79,492,636,41.332572,-75.0327092
01/01/2016 12:00:00 AM,42085,Northwest,West Central WDA,Mercer,43,45 to 64 Years,Female,16657,1186,7673,2595,1705,2153,1345,3498,5203,41.3023778,-80.2600941
01/01/2015 12:00:00 AM,42085,Northwest,West Central WDA,Mercer,43,45 to 64 Years,Female,16670,1223,7801,2548,1702,2150,1246,3396,5098,41.3023778,-80.2600941
01/01/2011 12:00:00 AM,42085,Northwest,West Central WDA,Mercer,43,45 to 64 Years,Male,16444,1653,7424,2985,1121,2103,1158,3261,4382,41.3023778,-80.2600941
01/01/2013 12:00:00 AM,42085,Northwest,West Central WDA,Mercer,43,45 to 64 Years,Female,16776,1127,7648,2898,1648,2331,1124,3455,5103,41.3023778,-80.2600941
01/01/2014 12:00:00 AM,42085,Northwest,West Central WDA,Mercer,43,45 to 64 Years,Female,16768,1292,7650,2620,1861,2221,1124,3345,5206,41.3023778,-80.2600941
01/01/2015 12:00:00 AM,42085,Northwest,West Central WDA,Mercer,43,45 to 64 Years,Male,16531,1477,7663,2681,1374,2226,1110,3336,4710,41.3023778,-80.2600941
01/01/2012 12:00:00 AM,42085,Northwest,West Central WDA,Mercer,43,45 to 64 Years,Male,16536,1609,7477,3019,1238,2094,1099,3193,4431,41.3023778,-80.2600941
01/01/2010 12:00:00 AM,42085,Northwest,West Central WDA,Mercer,43,45 to 64 Years,Male,16347,1511,7625,2946,1013,2175,1077,3252,4265,41.3023778,-80.2600941
01/01/2014 12:00:00 AM,42085,Northwest,West Central WDA,Mercer,43,45 to 64 Years,Male,16665,1459,7617,2800,1461,2260,1068,3328,4789,41.3023778,-80.2600941
01/01/2010 12:00:00 AM,42085,Northwest,West Central WDA,Mercer,43,45 to 64 Years,Female,16573,1124,7496,3074,1422,2390,1067,3457,4879,41.3023778,-80.2600941
01/01/2013 12:00:00 AM,42085,Northwest,West Central WDA,Mercer,43,45 to 64 Years,Male,16546,1529,7409,2939,1423,2208,1038,3246,4669,41.3023778,-80.2600941
01/01/2011 12:00:00 AM,42085,Northwest,West Central WDA,Mercer,43,45 to 64 Years,Female,16687,1103,7468,3048,1663,2371,1034,3405,5068,41.3023778,-80.2600941
01/01/2016 12:00:00 AM,42085,Northwest,West Central WDA,Mercer,43,45 to 64 Years,Male,16400,1416,7728,2610,1313,2320,1013,3333,4646,41.3023778,-80.2600941
01/01/2012 12:00:00 AM,42085,Northwest,West Central WDA,Mercer,43,45 to 64 Years,Female,16760,1125,7635,3043,1637,2320,1000,3320,4957,41.3023778,-80.2600941
01/01/2016 12:00:00 AM,42085,Northwest,West Central WDA,Mercer,43,25 to 34 Years,Female,5629,478,1579,1193,566,1144,669,1813,2379,41.3023778,-80.2600941
01/01/2016 12:00:00 AM,42085,Northwest,West Central WDA,Mercer,43,35 to 44 Years,Female,6238,436,1763,1137,1031,1204,667,1871,2902,41.3023778,-80.2600941
01/01/2015 12:00:00 AM,42085,Northwest,West Central WDA,Mercer,43,35 to 44 Years,Female,6467,480,2014,1119,922,1286,646,1932,2854,41.3023778,-80.2600941
01/01/2014 12:00:00 AM,42085,Northwest,West Central WDA,Mercer,43,35 to 44 Years,Female,6606,475,2070,1253,948,1258,602,1860,2808,41.3023778,-80.2600941
01/01/2015 12:00:00 AM,42085,Northwest,West Central WDA,Mercer,43,25 to 34 Years,Female,5690,470,1640,1215,498,1277,590,1867,2365,41.3023778,-80.2600941
01/01/2014 12:00:00 AM,42085,Northwest,West Central WDA,Mercer,43,25 to 34 Years,Female,5632,467,1673,1357,541,1019,575,1594,2135,41.3023778,-80.2600941
01/01/2013 12:00:00 AM,42085,Northwest,West Central WDA,Mercer,43,35 to 44 Years,Female,6733,469,2505,1148,772,1296,543,1839,2611,41.3023778,-80.2600941
01/01/2013 12:00:00 AM,42085,Northwest,West Central WDA,Mercer,43,25 to 34 Years,Female,5635,339,1745,1384,544,1091,532,1623,2167,41.3023778,-80.2600941
01/01/2010 12:00:00 AM,42085,Northwest,West Central WDA,Mercer,43,35 to 44 Years,Female,7241,542,2870,1435,777,1113,504,1617,2394,41.3023778,-80.2600941
01/01/2015 12:00:00 AM,42085,Northwest,West Central WDA,Mercer,43,35 to 44 Years,Male,6490,625,2492,1026,617,1231,499,1730,2347,41.3023778,-80.2600941
01/01/2011 12:00:00 AM,42085,Northwest,West Central WDA,Mercer,43,35 to 44 Years,Male,7343,789,3094,1086,553,1341,480,1821,2374,41.3023778,-80.2600941
01/01/2011 12:00:00 AM,42085,Northwest,West Central WDA,Mercer,43,35 to 44 Years,Female,7134,562,2768,1422,702,1200,480,1680,2382,41.3023778,-80.2600941
01/01/2012 12:00:00 AM,42085,Northwest,West Central WDA,Mercer,43,35 to 44 Years,Male,7078,749,2686,1151,607,1413,472,1885,2492,41.3023778,-80.2600941
01/01/2014 12:00:00 AM,42085,Northwest,West Central WDA,Mercer,43,35 to 44 Years,Male,6605,687,2433,1143,565,1306,471,1777,2342,41.3023778,-80.2600941
01/01/2016 12:00:00 AM,42085,Northwest,West Central WDA,Mercer,43,35 to 44 Years,Male,6254,638,2358,1041,649,1103,465,1568,2217,41.3023778,-80.2600941
01/01/2012 12:00:00 AM,42085,Northwest,West Central WDA,Mercer,43,35 to 44 Years,Female,6906,460,2543,1448,671,1326,458,1784,2455,41.3023778,-80.2600941
01/01/2012 12:00:00 AM,42085,Northwest,West Central WDA,Mercer,43,25 to 34 Years,Female,5612,400,1856,1323,504,1076,453,1529,2033,41.3023778,-80.2600941
01/01/2013 12:00:00 AM,42085,Northwest,West Central WDA,Mercer,43,35 to 44 Years,Male,6881,673,2725,1092,619,1325,447,1772,2391,41.3023778,-80.2600941
01/01/2011 12:00:00 AM,42085,Northwest,West Central WDA,Mercer,43,25 to 34 Years,Female,5609,372,1953,1264,507,1072,441,1513,2020,41.3023778,-80.2600941
01/01/2010 12:00:00 AM,42085,Northwest,West Central WDA,Mercer,43,35 to 44 Years,Male,7488,960,3199,1152,498,1269,410,1679,2177,41.3023778,-80.2600941
01/01/2010 12:00:00 AM,42085,Northwest,West Central WDA,Mercer,43,25 to 34 Years,Female,5664,434,1977,1242,560,1046,405,1451,2011,41.3023778,-80.2600941
01/01/2016 12:00:00 AM,42085,Northwest,West Central WDA,Mercer,43,25 to 34 Years,Male,5997,728,2437,949,536,1004,343,1347,1883,41.3023778,-80.2600941
01/01/2014 12:00:00 AM,42085,Northwest,West Central WDA,Mercer,43,25 to 34 Years,Male,5880,685,2241,1005,545,1084,320,1404,1949,41.3023778,-80.2600941
01/01/2013 12:00:00 AM,42085,Northwest,West Central WDA,Mercer,43,25 to 34 Years,Male,5844,648,2280,976,535,1100,305,1405,1940,41.3023778,-80.2600941
01/01/2011 12:00:00 AM,42085,Northwest,West Central WDA,Mercer,43,25 to 34 Years,Male,5661,562,2268,869,592,1065,305,1370,1962,41.3023778,-80.2600941
01/01/2015 12:00:00 AM,42085,Northwest,West Central WDA,Mercer,43,25 to 34 Years,Male,5943,715,2419,896,487,1128,298,1426,1913,41.3023778,-80.2600941
01/01/2012 12:00:00 AM,42085,Northwest,West Central WDA,Mercer,43,25 to 34 Years,Male,5713,615,2218,871,540,1189,280,1469,2009,41.3023778,-80.2600941
01/01/2010 12:00:00 AM,42085,Northwest,West Central WDA,Mercer,43,25 to 34 Years,Male,5735,523,2256,1006,616,1059,275,1334,1950,41.3023778,-80.2600941
01/01/2016 12:00:00 AM,42035,Northeast,Central WDA,Clinton,18,45 to 64 Years,Female,5013,423,2390,729,542,445,484,929,1471,41.2328627,-77.6428376
01/01/2015 12:00:00 AM,42035,Northeast,Central WDA,Clinton,18,45 to 64 Years,Female,5116,455,2472,799,488,493,409,902,1390,41.2328627,-77.6428376
01/01/2014 12:00:00 AM,42035,Northeast,Central WDA,Clinton,18,45 to 64 Years,Female,5140,484,2474,746,506,522,408,930,1436,41.2328627,-77.6428376
01/01/2013 12:00:00 AM,42035,Northeast,Central WDA,Clinton,18,45 to 64 Years,Male,4989,566,2309,809,470,465,370,835,1305,41.2328627,-77.6428376
01/01/2013 12:00:00 AM,42035,Northeast,Central WDA,Clinton,18,45 to 64 Years,Female,5184,524,2588,710,475,526,361,887,1362,41.2328627,-77.6428376
01/01/2010 12:00:00 AM,42035,Northeast,Central WDA,Clinton,18,45 to 64 Years,Female,5085,513,2581,601,432,598,360,958,1390,41.2328627,-77.6428376
01/01/2012 12:00:00 AM,42035,Northeast,Central WDA,Clinton,18,45 to 64 Years,Female,5203,486,2659,685,484,541,348,889,1373,41.2328627,-77.6428376
01/01/2011 12:00:00 AM,42035,Northeast,Central WDA,Clinton,18,45 to 64 Years,Female,5172,566,2600,637,461,564,344,908,1369,41.2328627,-77.6428376
01/01/2012 12:00:00 AM,42035,Northeast,Central WDA,Clinton,18,45 to 64 Years,Male,5058,581,2417,819,441,465,335,800,1241,41.2328627,-77.6428376
01/01/2010 12:00:00 AM,42035,Northeast,Central WDA,Clinton,18,45 to 64 Years,Male,5025,485,2452,703,514,541,330,871,1385,41.2328627,-77.6428376
01/01/2014 12:00:00 AM,42035,Northeast,Central WDA,Clinton,18,45 to 64 Years,Male,4992,552,2331,826,474,507,302,809,1283,41.2328627,-77.6428376
01/01/2011 12:00:00 AM,42035,Northeast,Central WDA,Clinton,18,45 to 64 Years,Male,5049,493,2522,814,488,431,301,732,1220,41.2328627,-77.6428376
01/01/2016 12:00:00 AM,42035,Northeast,Central WDA,Clinton,18,45 to 64 Years,Male,4910,536,2360,713,511,534,256,790,1301,41.2328627,-77.6428376
01/01/2015 12:00:00 AM,42035,Northeast,Central WDA,Clinton,18,45 to 64 Years,Male,4948,550,2390,775,483,495,255,750,1233,41.2328627,-77.6428376
01/01/2011 12:00:00 AM,42035,Northeast,Central WDA,Clinton,18,25 to 34 Years,Male,2042,315,921,240,126,262,178,440,566,41.2328627,-77.6428376
01/01/2013 12:00:00 AM,42035,Northeast,Central WDA,Clinton,18,35 to 44 Years,Female,2232,236,711,512,285,312,176,488,773,41.2328627,-77.6428376
01/01/2014 12:00:00 AM,42035,Northeast,Central WDA,Clinton,18,35 to 44 Years,Female,2187,205,672,448,381,308,173,481,862,41.2328627,-77.6428376
01/01/2015 12:00:00 AM,42035,Northeast,Central WDA,Clinton,18,35 to 44 Years,Female,2165,235,597,437,447,285,164,449,896,41.2328627,-77.6428376
01/01/2016 12:00:00 AM,42035,Northeast,Central WDA,Clinton,18,25 to 34 Years,Male,2175,281,979,350,131,291,143,434,565,41.2328627,-77.6428376
01/01/2016 12:00:00 AM,42035,Northeast,Central WDA,Clinton,18,35 to 44 Years,Female,2106,255,661,357,378,314,141,455,833,41.2328627,-77.6428376
01/01/2010 12:00:00 AM,42035,Northeast,Central WDA,Clinton,18,25 to 34 Years,Male,2085,354,866,291,164,271,139,410,574,41.2328627,-77.6428376
01/01/2012 12:00:00 AM,42035,Northeast,Central WDA,Clinton,18,35 to 44 Years,Female,2264,291,698,552,264,321,138,459,723,41.2328627,-77.6428376
01/01/2011 12:00:00 AM,42035,Northeast,Central WDA,Clinton,18,35 to 44 Years,Female,2290,231,814,503,284,324,134,458,742,41.2328627,-77.6428376
01/01/2014 12:00:00 AM,42035,Northeast,Central WDA,Clinton,18,25 to 34 Years,Female,1930,145,654,404,220,374,133,507,727,41.2328627,-77.6428376
01/01/2010 12:00:00 AM,42035,Northeast,Central WDA,Clinton,18,35 to 44 Years,Female,2310,195,920,484,282,298,131,429,711,41.2328627,-77.6428376
01/01/2012 12:00:00 AM,42035,Northeast,Central WDA,Clinton,18,25 to 34 Years,Male,2043,258,900,311,115,332,127,459,574,41.2328627,-77.6428376
01/01/2016 12:00:00 AM,42035,Northeast,Central WDA,Clinton,18,25 to 34 Years,Female,1943,136,713,364,214,390,126,516,730,41.2328627,-77.6428376
01/01/2013 12:00:00 AM,42035,Northeast,Central WDA,Clinton,18,25 to 34 Years,Female,1941,169,595,430,245,376,126,502,747,41.2328627,-77.6428376
01/01/2012 12:00:00 AM,42035,Northeast,Central WDA,Clinton,18,25 to 34 Years,Female,2008,163,639,408,230,457,111,568,798,41.2328627,-77.6428376
01/01/2015 12:00:00 AM,42035,Northeast,Central WDA,Clinton,18,25 to 34 Years,Male,2092,243,1016,328,121,282,102,384,505,41.2328627,-77.6428376
01/01/2015 12:00:00 AM,42035,Northeast,Central WDA,Clinton,18,25 to 34 Years,Female,1951,156,674,399,206,421,95,516,722,41.2328627,-77.6428376
01/01/2011 12:00:00 AM,42035,Northeast,Central WDA,Clinton,18,25 to 34 Years,Female,2004,172,679,403,234,424,92,516,750,41.2328627,-77.6428376
01/01/2014 12:00:00 AM,42035,Northeast,Central WDA,Clinton,18,25 to 34 Years,Male,2097,242,1062,303,105,298,87,385,490,41.2328627,-77.6428376
01/01/2010 12:00:00 AM,42035,Northeast,Central WDA,Clinton,18,25 to 34 Years,Female,2047,174,736,345,252,455,85,540,792,41.2328627,-77.6428376
01/01/2010 12:00:00 AM,42035,Northeast,Central WDA,Clinton,18,35 to 44 Years,Male,2264,193,1104,407,239,236,85,321,560,41.2328627,-77.6428376
01/01/2011 12:00:00 AM,42035,Northeast,Central WDA,Clinton,18,35 to 44 Years,Male,2227,183,1017,469,228,250,80,330,558,41.2328627,-77.6428376
01/01/2012 12:00:00 AM,42035,Northeast,Central WDA,Clinton,18,35 to 44 Years,Male,2198,196,956,447,264,256,79,335,599,41.2328627,-77.6428376
01/01/2013 12:00:00 AM,42035,Northeast,Central WDA,Clinton,18,25 to 34 Years,Male,2028,253,912,328,124,334,77,411,535,41.2328627,-77.6428376
01/01/2015 12:00:00 AM,42035,Northeast,Central WDA,Clinton,18,35 to 44 Years,Male,2096,175,925,367,262,293,74,367,629,41.2328627,-77.6428376
01/01/2013 12:00:00 AM,42035,Northeast,Central WDA,Clinton,18,35 to 44 Years,Male,2124,164,951,409,250,278,72,350,600,41.2328627,-77.6428376
01/01/2014 12:00:00 AM,42035,Northeast,Central WDA,Clinton,18,35 to 44 Years,Male,2150,181,975,379,257,294,64,358,615,41.2328627,-77.6428376
01/01/2016 12:00:00 AM,42035,Northeast,Central WDA,Clinton,18,35 to 44 Years,Male,2090,208,938,348,254,293,49,342,596,41.2328627,-77.6428376
01/01/2015 12:00:00 AM,42031,Northwest,Northwest WDA,Clarion,16,45 to 64 Years,Female,5396,416,2628,711,477,643,521,1164,1641,41.1927913,-79.4248361
01/01/2016 12:00:00 AM,42031,Northwest,Northwest WDA,Clarion,16,45 to 64 Years,Female,5413,450,2574,731,517,637,504,1141,1658,41.1927913,-79.4248361
01/01/2011 12:00:00 AM,42031,Northwest,Northwest WDA,Clarion,16,45 to 64 Years,Female,5313,404,2646,766,435,590,472,1062,1497,41.1927913,-79.4248361
01/01/2014 12:00:00 AM,42031,Northwest,Northwest WDA,Clarion,16,45 to 64 Years,Female,5367,436,2600,757,458,653,463,1116,1574,41.1927913,-79.4248361
01/01/2012 12:00:00 AM,42031,Northwest,Northwest WDA,Clarion,16,45 to 64 Years,Female,5381,402,2614,800,491,612,462,1074,1565,41.1927913,-79.4248361
01/01/2013 12:00:00 AM,42031,Northwest,Northwest WDA,Clarion,16,45 to 64 Years,Female,5403,410,2620,777,508,636,452,1088,1596,41.1927913,-79.4248361
01/01/2010 12:00:00 AM,42031,Northwest,Northwest WDA,Clarion,16,45 to 64 Years,Female,5326,411,2790,702,412,593,418,1011,1423,41.1927913,-79.4248361
01/01/2012 12:00:00 AM,42031,Northwest,Northwest WDA,Clarion,16,45 to 64 Years,Male,5351,438,2969,691,429,426,398,824,1253,41.1927913,-79.4248361
01/01/2016 12:00:00 AM,42031,Northwest,Northwest WDA,Clarion,16,45 to 64 Years,Male,5302,479,2870,576,484,517,376,893,1377,41.1927913,-79.4248361
01/01/2014 12:00:00 AM,42031,Northwest,Northwest WDA,Clarion,16,45 to 64 Years,Male,5369,483,2904,685,438,492,367,859,1297,41.1927913,-79.4248361
01/01/2011 12:00:00 AM,42031,Northwest,Northwest WDA,Clarion,16,45 to 64 Years,Male,5398,488,3026,702,391,424,367,791,1182,41.1927913,-79.4248361
01/01/2010 12:00:00 AM,42031,Northwest,Northwest WDA,Clarion,16,45 to 64 Years,Male,5411,532,3088,596,416,415,364,779,1195,41.1927913,-79.4248361
01/01/2013 12:00:00 AM,42031,Northwest,Northwest WDA,Clarion,16,45 to 64 Years,Male,5364,455,2947,678,498,426,360,786,1284,41.1927913,-79.4248361
01/01/2015 12:00:00 AM,42031,Northwest,Northwest WDA,Clarion,16,45 to 64 Years,Male,5357,495,2839,678,472,514,359,873,1345,41.1927913,-79.4248361
01/01/2016 12:00:00 AM,42031,Northwest,Northwest WDA,Clarion,16,25 to 34 Years,Female,2074,150,631,410,149,506,228,734,883,41.1927913,-79.4248361
01/01/2016 12:00:00 AM,42031,Northwest,Northwest WDA,Clarion,16,35 to 44 Years,Female,2108,132,678,362,236,473,227,700,936,41.1927913,-79.4248361
01/01/2012 12:00:00 AM,42031,Northwest,Northwest WDA,Clarion,16,35 to 44 Years,Female,2314,123,881,401,264,420,225,645,909,41.1927913,-79.4248361
01/01/2014 12:00:00 AM,42031,Northwest,Northwest WDA,Clarion,16,35 to 44 Years,Female,2166,108,734,380,293,440,211,651,944,41.1927913,-79.4248361
01/01/2015 12:00:00 AM,42031,Northwest,Northwest WDA,Clarion,16,35 to 44 Years,Female,2164,125,720,382,278,462,197,659,937,41.1927913,-79.4248361
01/01/2015 12:00:00 AM,42031,Northwest,Northwest WDA,Clarion,16,25 to 34 Years,Female,2033,118,636,431,184,470,194,664,848,41.1927913,-79.4248361
01/01/2013 12:00:00 AM,42031,Northwest,Northwest WDA,Clarion,16,35 to 44 Years,Female,2241,136,775,433,261,442,194,636,897,41.1927913,-79.4248361
01/01/2011 12:00:00 AM,42031,Northwest,Northwest WDA,Clarion,16,35 to 44 Years,Female,2391,200,952,341,296,408,194,602,898,41.1927913,-79.4248361
01/01/2010 12:00:00 AM,42031,Northwest,Northwest WDA,Clarion,16,35 to 44 Years,Female,2455,179,1058,337,249,442,190,632,881,41.1927913,-79.4248361
01/01/2014 12:00:00 AM,42031,Northwest,Northwest WDA,Clarion,16,25 to 34 Years,Female,1943,155,592,369,216,425,186,611,827,41.1927913,-79.4248361
01/01/2011 12:00:00 AM,42031,Northwest,Northwest WDA,Clarion,16,35 to 44 Years,Male,2353,157,1302,242,191,285,176,461,652,41.1927913,-79.4248361
01/01/2012 12:00:00 AM,42031,Northwest,Northwest WDA,Clarion,16,25 to 34 Years,Female,1899,201,500,415,232,384,167,551,783,41.1927913,-79.4248361
01/01/2012 12:00:00 AM,42031,Northwest,Northwest WDA,Clarion,16,35 to 44 Years,Male,2317,134,1144,318,213,352,156,508,721,41.1927913,-79.4248361
01/01/2013 12:00:00 AM,42031,Northwest,Northwest WDA,Clarion,16,25 to 34 Years,Female,1921,191,562,358,232,429,149,578,810,41.1927913,-79.4248361
01/01/2010 12:00:00 AM,42031,Northwest,Northwest WDA,Clarion,16,35 to 44 Years,Male,2391,139,1358,276,190,282,146,428,618,41.1927913,-79.4248361
01/01/2011 12:00:00 AM,42031,Northwest,Northwest WDA,Clarion,16,25 to 34 Years,Female,1916,166,542,431,262,375,140,515,777,41.1927913,-79.4248361
01/01/2013 12:00:00 AM,42031,Northwest,Northwest WDA,Clarion,16,35 to 44 Years,Male,2259,138,1115,271,235,369,131,500,735,41.1927913,-79.4248361
01/01/2015 12:00:00 AM,42031,Northwest,Northwest WDA,Clarion,16,25 to 34 Years,Male,2149,163,863,389,237,366,131,497,734,41.1927913,-79.4248361
01/01/2015 12:00:00 AM,42031,Northwest,Northwest WDA,Clarion,16,35 to 44 Years,Male,2131,234,906,279,207,379,126,505,712,41.1927913,-79.4248361
01/01/2016 12:00:00 AM,42031,Northwest,Northwest WDA,Clarion,16,25 to 34 Years,Male,2205,202,866,350,243,422,122,544,787,41.1927913,-79.4248361
01/01/2016 12:00:00 AM,42031,Northwest,Northwest WDA,Clarion,16,35 to 44 Years,Male,2096,285,804,295,241,354,117,471,712,41.1927913,-79.4248361
01/01/2010 12:00:00 AM,42031,Northwest,Northwest WDA,Clarion,16,25 to 34 Years,Female,1903,187,588,395,231,388,114,502,733,41.1927913,-79.4248361
01/01/2014 12:00:00 AM,42031,Northwest,Northwest WDA,Clarion,16,35 to 44 Years,Male,2182,221,959,277,218,401,106,507,725,41.1927913,-79.4248361
01/01/2014 12:00:00 AM,42031,Northwest,Northwest WDA,Clarion,16,25 to 34 Years,Male,2068,207,839,382,217,325,98,423,640,41.1927913,-79.4248361
01/01/2012 12:00:00 AM,42031,Northwest,Northwest WDA,Clarion,16,25 to 34 Years,Male,2001,234,823,362,202,291,89,380,582,41.1927913,-79.4248361
01/01/2013 12:00:00 AM,42031,Northwest,Northwest WDA,Clarion,16,25 to 34 Years,Male,2027,250,792,352,193,352,88,440,633,41.1927913,-79.4248361
01/01/2011 12:00:00 AM,42031,Northwest,Northwest WDA,Clarion,16,25 to 34 Years,Male,1971,217,787,379,198,315,75,390,588,41.1927913,-79.4248361
01/01/2010 12:00:00 AM,42031,Northwest,Northwest WDA,Clarion,16,25 to 34 Years,Male,1936,206,793,347,183,335,72,407,590,41.1927913,-79.4248361
01/01/2010 12:00:00 AM,42079,Northeast,Luzerne-Schuylkill Counties WDA,Luzerne,40,45 to 64 Years,Male,44468,4705,18474,7519,3490,5890,4390,10280,13770,41.1783644,-75.9919961
01/01/2011 12:00:00 AM,42079,Northeast,Luzerne-Schuylkill Counties WDA,Luzerne,40,45 to 64 Years,Male,45090,4474,18713,8163,3644,5900,4196,10096,13740,41.1783644,-75.9919961
01/01/2013 12:00:00 AM,42079,Northeast,Luzerne-Schuylkill Counties WDA,Luzerne,40,45 to 64 Years,Male,45659,4266,18643,8596,3647,6397,4110,10507,14154,41.1783644,-75.9919961
01/01/2010 12:00:00 AM,42079,Northeast,Luzerne-Schuylkill Counties WDA,Luzerne,40,45 to 64 Years,Female,44909,4097,18756,8411,4099,5465,4081,9546,13645,41.1783644,-75.9919961
01/01/2012 12:00:00 AM,42079,Northeast,Luzerne-Schuylkill Counties WDA,Luzerne,40,45 to 64 Years,Male,45416,4324,18484,8652,3621,6292,4043,10335,13956,41.1783644,-75.9919961
01/01/2016 12:00:00 AM,42079,Northeast,Luzerne-Schuylkill Counties WDA,Luzerne,40,45 to 64 Years,Female,45428,3566,17129,8609,5683,6438,4003,10441,16124,41.1783644,-75.9919961
01/01/2012 12:00:00 AM,42079,Northeast,Luzerne-Schuylkill Counties WDA,Luzerne,40,45 to 64 Years,Female,45848,3991,18242,9381,4771,5508,3955,9463,14234,41.1783644,-75.9919961
01/01/2011 12:00:00 AM,42079,Northeast,Luzerne-Schuylkill Counties WDA,Luzerne,40,45 to 64 Years,Female,45505,4084,18643,8859,4547,5437,3935,9372,13919,41.1783644,-75.9919961
01/01/2014 12:00:00 AM,42079,Northeast,Luzerne-Schuylkill Counties WDA,Luzerne,40,45 to 64 Years,Male,45591,4092,18569,8730,3814,6461,3925,10386,14200,41.1783644,-75.9919961
01/01/2013 12:00:00 AM,42079,Northeast,Luzerne-Schuylkill Counties WDA,Luzerne,40,45 to 64 Years,Female,45967,3915,18014,9339,5008,5836,3855,9691,14699,41.1783644,-75.9919961
01/01/2016 12:00:00 AM,42079,Northeast,Luzerne-Schuylkill Counties WDA,Luzerne,40,45 to 64 Years,Male,45108,4006,18335,8376,4234,6309,3848,10157,14391,41.1783644,-75.9919961
01/01/2015 12:00:00 AM,42079,Northeast,Luzerne-Schuylkill Counties WDA,Luzerne,40,45 to 64 Years,Female,45796,3572,17755,9055,5661,6016,3737,9753,15414,41.1783644,-75.9919961
01/01/2015 12:00:00 AM,42079,Northeast,Luzerne-Schuylkill Counties WDA,Luzerne,40,45 to 64 Years,Male,45453,4014,18488,8934,4035,6262,3720,9982,14017,41.1783644,-75.9919961
01/01/2014 12:00:00 AM,42079,Northeast,Luzerne-Schuylkill Counties WDA,Luzerne,40,45 to 64 Years,Female,45955,3778,17977,9347,5260,5906,3687,9593,14853,41.1783644,-75.9919961
01/01/2016 12:00:00 AM,42079,Northeast,Luzerne-Schuylkill Counties WDA,Luzerne,40,35 to 44 Years,Female,18472,1381,5319,3580,2364,3601,2227,5828,8192,41.1783644,-75.9919961
01/01/2014 12:00:00 AM,42079,Northeast,Luzerne-Schuylkill Counties WDA,Luzerne,40,35 to 44 Years,Female,19357,1615,5562,3812,2486,3737,2145,5882,8368,41.1783644,-75.9919961
01/01/2014 12:00:00 AM,42079,Northeast,Luzerne-Schuylkill Counties WDA,Luzerne,40,25 to 34 Years,Female,17639,1425,4528,3831,2008,3710,2137,5847,7855,41.1783644,-75.9919961
01/01/2016 12:00:00 AM,42079,Northeast,Luzerne-Schuylkill Counties WDA,Luzerne,40,25 to 34 Years,Female,18088,1462,4403,3984,2282,3828,2129,5957,8239,41.1783644,-75.9919961
01/01/2015 12:00:00 AM,42079,Northeast,Luzerne-Schuylkill Counties WDA,Luzerne,40,25 to 34 Years,Female,17879,1512,4325,3985,2069,3870,2118,5988,8057,41.1783644,-75.9919961
01/01/2015 12:00:00 AM,42079,Northeast,Luzerne-Schuylkill Counties WDA,Luzerne,40,35 to 44 Years,Female,18890,1388,5626,3859,2352,3565,2100,5665,8017,41.1783644,-75.9919961
01/01/2012 12:00:00 AM,42079,Northeast,Luzerne-Schuylkill Counties WDA,Luzerne,40,35 to 44 Years,Female,20287,1630,6303,4104,2580,3607,2063,5670,8250,41.1783644,-75.9919961
01/01/2013 12:00:00 AM,42079,Northeast,Luzerne-Schuylkill Counties WDA,Luzerne,40,35 to 44 Years,Female,19802,1595,5938,4101,2471,3695,2002,5697,8168,41.1783644,-75.9919961
01/01/2012 12:00:00 AM,42079,Northeast,Luzerne-Schuylkill Counties WDA,Luzerne,40,25 to 34 Years,Female,17151,1301,4644,3813,1622,3789,1982,5771,7393,41.1783644,-75.9919961
01/01/2013 12:00:00 AM,42079,Northeast,Luzerne-Schuylkill Counties WDA,Luzerne,40,25 to 34 Years,Female,17451,1393,4615,3797,1858,3841,1947,5788,7646,41.1783644,-75.9919961
01/01/2011 12:00:00 AM,42079,Northeast,Luzerne-Schuylkill Counties WDA,Luzerne,40,35 to 44 Years,Female,20763,1849,6246,4357,2786,3640,1885,5525,8311,41.1783644,-75.9919961
01/01/2011 12:00:00 AM,42079,Northeast,Luzerne-Schuylkill Counties WDA,Luzerne,40,25 to 34 Years,Female,17118,1271,4751,3577,1689,4136,1694,5830,7519,41.1783644,-75.9919961
01/01/2010 12:00:00 AM,42079,Northeast,Luzerne-Schuylkill Counties WDA,Luzerne,40,35 to 44 Years,Female,21247,1865,6711,4297,2967,3730,1677,5407,8374,41.1783644,-75.9919961
01/01/2010 12:00:00 AM,42079,Northeast,Luzerne-Schuylkill Counties WDA,Luzerne,40,25 to 34 Years,Female,17023,1199,4767,3640,1770,4073,1574,5647,7417,41.1783644,-75.9919961
01/01/2013 12:00:00 AM,42079,Northeast,Luzerne-Schuylkill Counties WDA,Luzerne,40,35 to 44 Years,Male,20644,2000,7717,4374,2133,2912,1508,4420,6553,41.1783644,-75.9919961
01/01/2014 12:00:00 AM,42079,Northeast,Luzerne-Schuylkill Counties WDA,Luzerne,40,35 to 44 Years,Male,20112,2002,7514,4135,2043,2943,1475,4418,6461,41.1783644,-75.9919961
01/01/2011 12:00:00 AM,42079,Northeast,Luzerne-Schuylkill Counties WDA,Luzerne,40,35 to 44 Years,Male,21731,2085,8461,4562,2164,3001,1458,4459,6623,41.1783644,-75.9919961
01/01/2012 12:00:00 AM,42079,Northeast,Luzerne-Schuylkill Counties WDA,Luzerne,40,35 to 44 Years,Male,21214,2075,8063,4628,2094,2900,1454,4354,6448,41.1783644,-75.9919961
01/01/2015 12:00:00 AM,42079,Northeast,Luzerne-Schuylkill Counties WDA,Luzerne,40,35 to 44 Years,Male,19648,2032,7237,4131,2007,2850,1391,4241,6248,41.1783644,-75.9919961
01/01/2016 12:00:00 AM,42079,Northeast,Luzerne-Schuylkill Counties WDA,Luzerne,40,35 to 44 Years,Male,19203,2110,7048,3934,1978,2783,1350,4133,6111,41.1783644,-75.9919961
01/01/2010 12:00:00 AM,42079,Northeast,Luzerne-Schuylkill Counties WDA,Luzerne,40,35 to 44 Years,Male,22209,2140,8895,4472,2341,3012,1349,4361,6702,41.1783644,-75.9919961
01/01/2015 12:00:00 AM,42079,Northeast,Luzerne-Schuylkill Counties WDA,Luzerne,40,25 to 34 Years,Male,19715,1990,7035,4404,1825,3380,1081,4461,6286,41.1783644,-75.9919961
01/01/2016 12:00:00 AM,42079,Northeast,Luzerne-Schuylkill Counties WDA,Luzerne,40,25 to 34 Years,Male,20118,1945,7385,4484,1967,3268,1069,4337,6304,41.1783644,-75.9919961
01/01/2014 12:00:00 AM,42079,Northeast,Luzerne-Schuylkill Counties WDA,Luzerne,40,25 to 34 Years,Male,19186,2022,6373,4532,1769,3518,972,4490,6259,41.1783644,-75.9919961
01/01/2013 12:00:00 AM,42079,Northeast,Luzerne-Schuylkill Counties WDA,Luzerne,40,25 to 34 Years,Male,18744,1880,6197,4600,1792,3423,852,4275,6067,41.1783644,-75.9919961
01/01/2012 12:00:00 AM,42079,Northeast,Luzerne-Schuylkill Counties WDA,Luzerne,40,25 to 34 Years,Male,18297,2301,6304,4044,1644,3223,781,4004,5648,41.1783644,-75.9919961
01/01/2011 12:00:00 AM,42079,Northeast,Luzerne-Schuylkill Counties WDA,Luzerne,40,25 to 34 Years,Male,17971,2111,6382,3837,1602,3424,615,4039,5641,41.1783644,-75.9919961
01/01/2010 12:00:00 AM,42079,Northeast,Luzerne-Schuylkill Counties WDA,Luzerne,40,25 to 34 Years,Male,17823,2085,6425,3762,1581,3398,572,3970,5551,41.1783644,-75.9919961
01/01/2014 12:00:00 AM,42065,Northwest,North Central WDA,Jefferson,33,45 to 64 Years,Female,6538,495,3442,951,651,620,379,999,1650,41.1313909,-79.0010181
01/01/2011 12:00:00 AM,42065,Northwest,North Central WDA,Jefferson,33,45 to 64 Years,Female,6507,576,3602,961,521,495,352,847,1368,41.1313909,-79.0010181
01/01/2016 12:00:00 AM,42065,Northwest,North Central WDA,Jefferson,33,45 to 64 Years,Female,6419,422,3442,885,719,601,350,951,1670,41.1313909,-79.0010181
01/01/2012 12:00:00 AM,42065,Northwest,North Central WDA,Jefferson,33,45 to 64 Years,Female,6553,611,3567,974,552,501,348,849,1401,41.1313909,-79.0010181
01/01/2010 12:00:00 AM,42065,Northwest,North Central WDA,Jefferson,33,45 to 64 Years,Female,6410,521,3557,913,540,533,346,879,1419,41.1313909,-79.0010181
01/01/2015 12:00:00 AM,42065,Northwest,North Central WDA,Jefferson,33,45 to 64 Years,Female,6510,496,3457,886,683,650,338,988,1671,41.1313909,-79.0010181
01/01/2013 12:00:00 AM,42065,Northwest,North Central WDA,Jefferson,33,45 to 64 Years,Female,6557,558,3546,943,626,558,326,884,1510,41.1313909,-79.0010181
01/01/2016 12:00:00 AM,42065,Northwest,North Central WDA,Jefferson,33,45 to 64 Years,Male,6450,577,3616,832,511,590,324,914,1425,41.1313909,-79.0010181
01/01/2010 12:00:00 AM,42065,Northwest,North Central WDA,Jefferson,33,45 to 64 Years,Male,6489,617,3773,807,469,515,308,823,1292,41.1313909,-79.0010181
01/01/2014 12:00:00 AM,42065,Northwest,North Central WDA,Jefferson,33,45 to 64 Years,Male,6559,633,3763,761,528,573,301,874,1402,41.1313909,-79.0010181
01/01/2015 12:00:00 AM,42065,Northwest,North Central WDA,Jefferson,33,45 to 64 Years,Male,6506,610,3693,815,531,568,289,857,1388,41.1313909,-79.0010181
01/01/2013 12:00:00 AM,42065,Northwest,North Central WDA,Jefferson,33,45 to 64 Years,Male,6596,716,3705,794,552,550,279,829,1381,41.1313909,-79.0010181
01/01/2012 12:00:00 AM,42065,Northwest,North Central WDA,Jefferson,33,45 to 64 Years,Male,6599,700,3731,845,541,523,259,782,1323,41.1313909,-79.0010181
01/01/2011 12:00:00 AM,42065,Northwest,North Central WDA,Jefferson,33,45 to 64 Years,Male,6591,673,3718,854,527,568,251,819,1346,41.1313909,-79.0010181
01/01/2014 12:00:00 AM,42065,Northwest,North Central WDA,Jefferson,33,25 to 34 Years,Female,2375,179,752,481,384,393,186,579,963,41.1313909,-79.0010181
01/01/2015 12:00:00 AM,42065,Northwest,North Central WDA,Jefferson,33,25 to 34 Years,Female,2385,242,710,450,385,423,175,598,983,41.1313909,-79.0010181
01/01/2012 12:00:00 AM,42065,Northwest,North Central WDA,Jefferson,33,25 to 34 Years,Female,2336,222,824,471,323,327,169,496,819,41.1313909,-79.0010181
01/01/2013 12:00:00 AM,42065,Northwest,North Central WDA,Jefferson,33,25 to 34 Years,Female,2359,256,745,474,359,362,163,525,884,41.1313909,-79.0010181
01/01/2016 12:00:00 AM,42065,Northwest,North Central WDA,Jefferson,33,25 to 34 Years,Female,2404,260,768,448,384,385,159,544,928,41.1313909,-79.0010181
01/01/2016 12:00:00 AM,42065,Northwest,North Central WDA,Jefferson,33,35 to 44 Years,Female,2482,159,950,405,436,375,157,532,968,41.1313909,-79.0010181
01/01/2015 12:00:00 AM,42065,Northwest,North Central WDA,Jefferson,33,35 to 44 Years,Female,2526,154,1044,388,406,380,154,534,940,41.1313909,-79.0010181
01/01/2011 12:00:00 AM,42065,Northwest,North Central WDA,Jefferson,33,25 to 34 Years,Female,2320,221,877,461,291,327,143,470,761,41.1313909,-79.0010181
01/01/2012 12:00:00 AM,42065,Northwest,North Central WDA,Jefferson,33,35 to 44 Years,Female,2725,146,1237,398,439,363,142,505,944,41.1313909,-79.0010181
01/01/2014 12:00:00 AM,42065,Northwest,North Central WDA,Jefferson,33,35 to 44 Years,Female,2575,122,1128,398,403,384,140,524,927,41.1313909,-79.0010181
01/01/2010 12:00:00 AM,42065,Northwest,North Central WDA,Jefferson,33,25 to 34 Years,Female,2336,226,937,490,254,298,131,429,683,41.1313909,-79.0010181
01/01/2011 12:00:00 AM,42065,Northwest,North Central WDA,Jefferson,33,35 to 44 Years,Female,2794,211,1302,452,361,346,122,468,829,41.1313909,-79.0010181
01/01/2013 12:00:00 AM,42065,Northwest,North Central WDA,Jefferson,33,35 to 44 Years,Female,2652,135,1174,424,406,394,119,513,919,41.1313909,-79.0010181
01/01/2010 12:00:00 AM,42065,Northwest,North Central WDA,Jefferson,33,35 to 44 Years,Female,2869,188,1377,487,357,348,112,460,817,41.1313909,-79.0010181
01/01/2016 12:00:00 AM,42065,Northwest,North Central WDA,Jefferson,33,35 to 44 Years,Male,2527,123,1380,334,323,256,111,367,690,41.1313909,-79.0010181
01/01/2015 12:00:00 AM,42065,Northwest,North Central WDA,Jefferson,33,25 to 34 Years,Male,2545,299,1123,416,362,253,92,345,707,41.1313909,-79.0010181
01/01/2015 12:00:00 AM,42065,Northwest,North Central WDA,Jefferson,33,35 to 44 Years,Male,2584,121,1400,401,320,253,89,342,662,41.1313909,-79.0010181
01/01/2016 12:00:00 AM,42065,Northwest,North Central WDA,Jefferson,33,25 to 34 Years,Male,2578,333,1153,363,363,294,72,366,729,41.1313909,-79.0010181
01/01/2013 12:00:00 AM,42065,Northwest,North Central WDA,Jefferson,33,25 to 34 Years,Male,2495,264,1045,376,424,316,70,386,810,41.1313909,-79.0010181
01/01/2014 12:00:00 AM,42065,Northwest,North Central WDA,Jefferson,33,25 to 34 Years,Male,2506,249,1061,395,419,316,66,382,801,41.1313909,-79.0010181
01/01/2014 12:00:00 AM,42065,Northwest,North Central WDA,Jefferson,33,35 to 44 Years,Male,2676,155,1503,384,337,233,64,297,634,41.1313909,-79.0010181
01/01/2012 12:00:00 AM,42065,Northwest,North Central WDA,Jefferson,33,35 to 44 Years,Male,2774,182,1646,305,345,242,54,296,641,41.1313909,-79.0010181
01/01/2013 12:00:00 AM,42065,Northwest,North Central WDA,Jefferson,33,35 to 44 Years,Male,2696,185,1529,353,345,236,48,284,629,41.1313909,-79.0010181
01/01/2011 12:00:00 AM,42065,Northwest,North Central WDA,Jefferson,33,25 to 34 Years,Male,2434,201,1203,328,344,312,46,358,702,41.1313909,-79.0010181
01/01/2012 12:00:00 AM,42065,Northwest,North Central WDA,Jefferson,33,25 to 34 Years,Male,2451,271,1118,331,355,332,44,376,731,41.1313909,-79.0010181
01/01/2011 12:00:00 AM,42065,Northwest,North Central WDA,Jefferson,33,35 to 44 Years,Male,2875,270,1731,301,304,230,39,269,573,41.1313909,-79.0010181
01/01/2010 12:00:00 AM,42065,Northwest,North Central WDA,Jefferson,33,35 to 44 Years,Male,2984,284,1875,291,269,230,35,265,534,41.1313909,-79.0010181
01/01/2010 12:00:00 AM,42065,Northwest,North Central WDA,Jefferson,33,25 to 34 Years,Male,2424,200,1172,345,357,326,24,350,707,41.1313909,-79.0010181
01/01/2016 12:00:00 AM,42089,Lehigh Valley,Pocono Counties WDA,Monroe,45,45 to 64 Years,Female,26412,1942,9525,5786,2589,3889,2681,6570,9159,41.0609179,-75.340836
01/01/2014 12:00:00 AM,42089,Lehigh Valley,Pocono Counties WDA,Monroe,45,45 to 64 Years,Female,26325,2160,10026,5688,2513,3271,2667,5938,8451,41.0609179,-75.340836
01/01/2013 12:00:00 AM,42089,Lehigh Valley,Pocono Counties WDA,Monroe,45,45 to 64 Years,Female,26231,2113,10011,5682,2446,3405,2574,5979,8425,41.0609179,-75.340836
01/01/2012 12:00:00 AM,42089,Lehigh Valley,Pocono Counties WDA,Monroe,45,45 to 64 Years,Female,25713,2096,9557,6096,2159,3281,2524,5805,7964,41.0609179,-75.340836
01/01/2015 12:00:00 AM,42089,Lehigh Valley,Pocono Counties WDA,Monroe,45,45 to 64 Years,Female,26445,2004,10108,5830,2535,3594,2374,5968,8503,41.0609179,-75.340836
01/01/2010 12:00:00 AM,42089,Lehigh Valley,Pocono Counties WDA,Monroe,45,45 to 64 Years,Female,24519,2005,9488,5155,2293,3343,2235,5578,7871,41.0609179,-75.340836
01/01/2010 12:00:00 AM,42089,Lehigh Valley,Pocono Counties WDA,Monroe,45,45 to 64 Years,Male,24008,2727,9299,4123,1616,4054,2189,6243,7859,41.0609179,-75.340836
01/01/2013 12:00:00 AM,42089,Lehigh Valley,Pocono Counties WDA,Monroe,45,45 to 64 Years,Male,25642,2356,10412,4996,1617,4083,2178,6261,7878,41.0609179,-75.340836
01/01/2014 12:00:00 AM,42089,Lehigh Valley,Pocono Counties WDA,Monroe,45,45 to 64 Years,Male,25830,2200,10861,5269,1570,3763,2167,5930,7500,41.0609179,-75.340836
01/01/2011 12:00:00 AM,42089,Lehigh Valley,Pocono Counties WDA,Monroe,45,45 to 64 Years,Female,25099,2060,9667,5640,2285,3299,2148,5447,7732,41.0609179,-75.340836
01/01/2011 12:00:00 AM,42089,Lehigh Valley,Pocono Counties WDA,Monroe,45,45 to 64 Years,Male,24736,2647,9841,4455,1688,3984,2121,6105,7793,41.0609179,-75.340836
01/01/2012 12:00:00 AM,42089,Lehigh Valley,Pocono Counties WDA,Monroe,45,45 to 64 Years,Male,25181,2284,9930,5134,1790,4050,1993,6043,7833,41.0609179,-75.340836
01/01/2015 12:00:00 AM,42089,Lehigh Valley,Pocono Counties WDA,Monroe,45,45 to 64 Years,Male,25866,2293,10727,5606,1627,3621,1992,5613,7240,41.0609179,-75.340836
01/01/2016 12:00:00 AM,42089,Lehigh Valley,Pocono Counties WDA,Monroe,45,45 to 64 Years,Male,25649,2489,10453,5520,1701,3547,1939,5486,7187,41.0609179,-75.340836
01/01/2010 12:00:00 AM,42089,Lehigh Valley,Pocono Counties WDA,Monroe,45,35 to 44 Years,Female,12744,938,3875,2630,1622,2456,1223,3679,5301,41.0609179,-75.340836
01/01/2011 12:00:00 AM,42089,Lehigh Valley,Pocono Counties WDA,Monroe,45,35 to 44 Years,Female,12375,725,3480,2736,1847,2390,1197,3587,5434,41.0609179,-75.340836
01/01/2012 12:00:00 AM,42089,Lehigh Valley,Pocono Counties WDA,Monroe,45,35 to 44 Years,Female,11860,555,3417,2762,1691,2335,1100,3435,5126,41.0609179,-75.340836
01/01/2013 12:00:00 AM,42089,Lehigh Valley,Pocono Counties WDA,Monroe,45,35 to 44 Years,Female,11305,586,3127,2454,1547,2503,1088,3591,5138,41.0609179,-75.340836
01/01/2013 12:00:00 AM,42089,Lehigh Valley,Pocono Counties WDA,Monroe,45,35 to 44 Years,Male,10120,768,3597,2178,989,1701,887,2588,3577,41.0609179,-75.340836
01/01/2016 12:00:00 AM,42089,Lehigh Valley,Pocono Counties WDA,Monroe,45,35 to 44 Years,Female,10063,536,3247,2465,1056,1875,884,2759,3815,41.0609179,-75.340836
01/01/2014 12:00:00 AM,42089,Lehigh Valley,Pocono Counties WDA,Monroe,45,35 to 44 Years,Female,10890,473,3093,2499,1736,2208,881,3089,4825,41.0609179,-75.340836
01/01/2010 12:00:00 AM,42089,Lehigh Valley,Pocono Counties WDA,Monroe,45,35 to 44 Years,Male,12016,1214,4388,2393,1142,2022,857,2879,4021,41.0609179,-75.340836
01/01/2015 12:00:00 AM,42089,Lehigh Valley,Pocono Counties WDA,Monroe,45,35 to 44 Years,Female,10499,523,2954,2597,1516,2080,829,2909,4425,41.0609179,-75.340836
01/01/2012 12:00:00 AM,42089,Lehigh Valley,Pocono Counties WDA,Monroe,45,35 to 44 Years,Male,10803,1138,3978,2192,1014,1676,805,2481,3495,41.0609179,-75.340836
01/01/2016 12:00:00 AM,42089,Lehigh Valley,Pocono Counties WDA,Monroe,45,25 to 34 Years,Female,8304,420,1651,2531,915,2053,734,2787,3702,41.0609179,-75.340836
01/01/2015 12:00:00 AM,42089,Lehigh Valley,Pocono Counties WDA,Monroe,45,25 to 34 Years,Female,8142,445,1733,2273,1073,1884,734,2618,3691,41.0609179,-75.340836
01/01/2015 12:00:00 AM,42089,Lehigh Valley,Pocono Counties WDA,Monroe,45,35 to 44 Years,Male,9130,738,3353,1985,935,1388,731,2119,3054,41.0609179,-75.340836
01/01/2014 12:00:00 AM,42089,Lehigh Valley,Pocono Counties WDA,Monroe,45,35 to 44 Years,Male,9623,739,3622,1971,950,1615,726,2341,3291,41.0609179,-75.340836
01/01/2016 12:00:00 AM,42089,Lehigh Valley,Pocono Counties WDA,Monroe,45,35 to 44 Years,Male,8785,775,3349,1862,878,1200,721,1921,2799,41.0609179,-75.340836
01/01/2013 12:00:00 AM,42089,Lehigh Valley,Pocono Counties WDA,Monroe,45,25 to 34 Years,Female,7983,475,1879,1821,1073,2016,719,2735,3808,41.0609179,-75.340836
01/01/2011 12:00:00 AM,42089,Lehigh Valley,Pocono Counties WDA,Monroe,45,25 to 34 Years,Female,8179,553,2305,1440,1390,1774,717,2491,3881,41.0609179,-75.340836
01/01/2012 12:00:00 AM,42089,Lehigh Valley,Pocono Counties WDA,Monroe,45,25 to 34 Years,Female,8144,489,2057,1799,1227,1871,701,2572,3799,41.0609179,-75.340836
01/01/2011 12:00:00 AM,42089,Lehigh Valley,Pocono Counties WDA,Monroe,45,35 to 44 Years,Male,11483,1191,4182,2471,993,1966,680,2646,3639,41.0609179,-75.340836
01/01/2014 12:00:00 AM,42089,Lehigh Valley,Pocono Counties WDA,Monroe,45,25 to 34 Years,Female,7996,427,1725,2070,1188,1956,630,2586,3774,41.0609179,-75.340836
01/01/2010 12:00:00 AM,42089,Lehigh Valley,Pocono Counties WDA,Monroe,45,25 to 34 Years,Female,8174,516,2542,1483,1125,1927,581,2508,3633,41.0609179,-75.340836
01/01/2011 12:00:00 AM,42089,Lehigh Valley,Pocono Counties WDA,Monroe,45,25 to 34 Years,Male,7857,760,2800,1648,792,1399,458,1857,2649,41.0609179,-75.340836
01/01/2012 12:00:00 AM,42089,Lehigh Valley,Pocono Counties WDA,Monroe,45,25 to 34 Years,Male,8039,784,2670,1895,917,1342,431,1773,2690,41.0609179,-75.340836
01/01/2013 12:00:00 AM,42089,Lehigh Valley,Pocono Counties WDA,Monroe,45,25 to 34 Years,Male,8167,771,2730,2025,966,1245,430,1675,2641,41.0609179,-75.340836
01/01/2015 12:00:00 AM,42089,Lehigh Valley,Pocono Counties WDA,Monroe,45,25 to 34 Years,Male,8635,994,2536,2282,890,1541,392,1933,2823,41.0609179,-75.340836
01/01/2016 12:00:00 AM,42089,Lehigh Valley,Pocono Counties WDA,Monroe,45,25 to 34 Years,Male,9042,1049,2866,2348,760,1644,375,2019,2779,41.0609179,-75.340836
01/01/2010 12:00:00 AM,42089,Lehigh Valley,Pocono Counties WDA,Monroe,45,25 to 34 Years,Male,7845,739,3139,1422,800,1381,364,1745,2545,41.0609179,-75.340836
01/01/2014 12:00:00 AM,42089,Lehigh Valley,Pocono Counties WDA,Monroe,45,25 to 34 Years,Male,8337,811,2710,2217,885,1410,304,1714,2599,41.0609179,-75.340836
01/01/2013 12:00:00 AM,42037,Northeast,Central WDA,Columbia,19,45 to 64 Years,Female,9356,707,4513,1331,745,1264,796,2060,2805,41.0491209,-76.4100218
01/01/2011 12:00:00 AM,42037,Northeast,Central WDA,Columbia,19,45 to 64 Years,Female,9240,902,4313,1422,738,1085,780,1865,2603,41.0491209,-76.4100218
01/01/2012 12:00:00 AM,42037,Northeast,Central WDA,Columbia,19,45 to 64 Years,Female,9399,926,4359,1377,773,1195,769,1964,2737,41.0491209,-76.4100218
01/01/2014 12:00:00 AM,42037,Northeast,Central WDA,Columbia,19,45 to 64 Years,Female,9356,666,4455,1343,831,1317,744,2061,2892,41.0491209,-76.4100218
01/01/2010 12:00:00 AM,42037,Northeast,Central WDA,Columbia,19,45 to 64 Years,Female,9083,919,4314,1410,658,1045,737,1782,2440,41.0491209,-76.4100218
01/01/2015 12:00:00 AM,42037,Northeast,Central WDA,Columbia,19,45 to 64 Years,Female,9377,719,4563,1366,812,1197,720,1917,2729,41.0491209,-76.4100218
01/01/2014 12:00:00 AM,42037,Northeast,Central WDA,Columbia,19,45 to 64 Years,Male,8983,703,4325,1383,642,1212,718,1930,2572,41.0491209,-76.4100218
01/01/2015 12:00:00 AM,42037,Northeast,Central WDA,Columbia,19,45 to 64 Years,Male,8944,760,4290,1461,674,1094,665,1759,2433,41.0491209,-76.4100218
01/01/2013 12:00:00 AM,42037,Northeast,Central WDA,Columbia,19,45 to 64 Years,Male,8951,745,4250,1406,628,1263,659,1922,2550,41.0491209,-76.4100218
01/01/2016 12:00:00 AM,42037,Northeast,Central WDA,Columbia,19,45 to 64 Years,Female,9273,634,4447,1409,861,1271,651,1922,2783,41.0491209,-76.4100218
01/01/2011 12:00:00 AM,42037,Northeast,Central WDA,Columbia,19,45 to 64 Years,Male,8862,974,4286,1307,448,1222,625,1847,2295,41.0491209,-76.4100218
01/01/2010 12:00:00 AM,42037,Northeast,Central WDA,Columbia,19,45 to 64 Years,Male,8754,1005,4256,1191,502,1179,621,1800,2302,41.0491209,-76.4100218
01/01/2016 12:00:00 AM,42037,Northeast,Central WDA,Columbia,19,45 to 64 Years,Male,8845,814,4223,1377,725,1107,599,1706,2431,41.0491209,-76.4100218
01/01/2012 12:00:00 AM,42037,Northeast,Central WDA,Columbia,19,45 to 64 Years,Male,8937,901,4265,1395,526,1252,598,1850,2376,41.0491209,-76.4100218
01/01/2016 12:00:00 AM,42037,Northeast,Central WDA,Columbia,19,35 to 44 Years,Female,3543,123,1195,683,378,749,415,1164,1542,41.0491209,-76.4100218
01/01/2015 12:00:00 AM,42037,Northeast,Central WDA,Columbia,19,35 to 44 Years,Female,3616,156,1339,663,337,771,350,1121,1458,41.0491209,-76.4100218
01/01/2011 12:00:00 AM,42037,Northeast,Central WDA,Columbia,19,35 to 44 Years,Female,4148,261,1597,800,509,635,346,981,1490,41.0491209,-76.4100218
01/01/2012 12:00:00 AM,42037,Northeast,Central WDA,Columbia,19,35 to 44 Years,Female,4101,269,1457,827,512,705,331,1036,1548,41.0491209,-76.4100218
01/01/2013 12:00:00 AM,42037,Northeast,Central WDA,Columbia,19,35 to 44 Years,Female,4028,243,1397,861,470,730,327,1057,1527,41.0491209,-76.4100218
01/01/2010 12:00:00 AM,42037,Northeast,Central WDA,Columbia,19,35 to 44 Years,Female,4246,243,1675,732,578,700,318,1018,1596,41.0491209,-76.4100218
01/01/2014 12:00:00 AM,42037,Northeast,Central WDA,Columbia,19,35 to 44 Years,Female,3766,149,1398,772,476,664,307,971,1447,41.0491209,-76.4100218
01/01/2011 12:00:00 AM,42037,Northeast,Central WDA,Columbia,19,25 to 34 Years,Female,3212,242,1146,688,311,535,290,825,1136,41.0491209,-76.4100218
01/01/2016 12:00:00 AM,42037,Northeast,Central WDA,Columbia,19,25 to 34 Years,Male,3446,292,1186,747,286,705,230,935,1221,41.0491209,-76.4100218
01/01/2010 12:00:00 AM,42037,Northeast,Central WDA,Columbia,19,25 to 34 Years,Female,3197,186,1161,746,338,539,227,766,1104,41.0491209,-76.4100218
01/01/2013 12:00:00 AM,42037,Northeast,Central WDA,Columbia,19,25 to 34 Years,Male,3489,453,1343,662,219,594,218,812,1031,41.0491209,-76.4100218
01/01/2011 12:00:00 AM,42037,Northeast,Central WDA,Columbia,19,35 to 44 Years,Male,3922,329,1797,716,303,560,217,777,1080,41.0491209,-76.4100218
01/01/2010 12:00:00 AM,42037,Northeast,Central WDA,Columbia,19,35 to 44 Years,Male,4068,358,1910,807,281,504,208,712,993,41.0491209,-76.4100218
01/01/2011 12:00:00 AM,42037,Northeast,Central WDA,Columbia,19,25 to 34 Years,Male,3546,398,1572,688,190,519,179,698,888,41.0491209,-76.4100218
01/01/2010 12:00:00 AM,42037,Northeast,Central WDA,Columbia,19,25 to 34 Years,Male,3470,314,1537,739,184,535,161,696,880,41.0491209,-76.4100218
01/01/2014 12:00:00 AM,42037,Northeast,Central WDA,Columbia,,25 to 34 Years,Female,3341,251,1054,586,289,729,432,1161,1450,41.0491209,-76.4100218
01/01/2013 12:00:00 AM,42037,Northeast,Central WDA,Columbia,,25 to 34 Years,Female,3268,299,1066,520,315,667,401,1068,1383,41.0491209,-76.4100218
01/01/2015 12:00:00 AM,42037,Northeast,Central WDA,Columbia,,25 to 34 Years,Female,3329,228,992,614,332,764,399,1163,1495,41.0491209,-76.4100218
01/01/2016 12:00:00 AM,42037,Northeast,Central WDA,Columbia,,25 to 34 Years,Female,3299,203,973,651,364,742,366,1108,1472,41.0491209,-76.4100218
01/01/2012 12:00:00 AM,42037,Northeast,Central WDA,Columbia,,25 to 34 Years,Female,3256,342,1018,654,281,609,352,961,1242,41.0491209,-76.4100218
01/01/2014 12:00:00 AM,42037,Northeast,Central WDA,Columbia,,35 to 44 Years,Male,3867,294,1745,550,345,619,314,933,1278,41.0491209,-76.4100218
01/01/2015 12:00:00 AM,42037,Northeast,Central WDA,Columbia,,35 to 44 Years,Male,3829,435,1671,465,409,550,299,849,1258,41.0491209,-76.4100218
01/01/2016 12:00:00 AM,42037,Northeast,Central WDA,Columbia,,35 to 44 Years,Male,3794,464,1493,652,395,513,277,790,1185,41.0491209,-76.4100218
01/01/2013 12:00:00 AM,42037,Northeast,Central WDA,Columbia,,35 to 44 Years,Male,3859,317,1717,643,300,607,275,882,1182,41.0491209,-76.4100218
01/01/2012 12:00:00 AM,42037,Northeast,Central WDA,Columbia,,35 to 44 Years,Male,3839,357,1708,624,261,642,247,889,1150,41.0491209,-76.4100218
01/01/2014 12:00:00 AM,42037,Northeast,Central WDA,Columbia,,25 to 34 Years,Male,3435,355,1338,610,208,707,217,924,1132,41.0491209,-76.4100218
01/01/2012 12:00:00 AM,42037,Northeast,Central WDA,Columbia,,25 to 34 Years,Male,3456,398,1512,565,192,575,214,789,981,41.0491209,-76.4100218
01/01/2015 12:00:00 AM,42037,Northeast,Central WDA,Columbia,,25 to 34 Years,Male,3418,366,1273,601,270,713,195,908,1178,41.0491209,-76.4100218
01/01/2013 12:00:00 AM,42093,Northeast,Central WDA,Montour,47,45 to 64 Years,Male,2649,196,1156,372,211,367,347,714,925,41.0280182,-76.6647053
01/01/2011 12:00:00 AM,42093,Northeast,Central WDA,Montour,47,45 to 64 Years,Male,2635,208,1148,357,299,279,344,623,922,41.0280182,-76.6647053
01/01/2012 12:00:00 AM,42093,Northeast,Central WDA,Montour,47,45 to 64 Years,Male,2620,230,1144,381,202,322,341,663,865,41.0280182,-76.6647053
01/01/2015 12:00:00 AM,42093,Northeast,Central WDA,Montour,47,45 to 64 Years,Male,2575,207,1173,291,156,421,327,748,904,41.0280182,-76.6647053
01/01/2010 12:00:00 AM,42093,Northeast,Central WDA,Montour,47,45 to 64 Years,Male,2626,268,1171,273,274,315,325,640,914,41.0280182,-76.6647053
01/01/2015 12:00:00 AM,42093,Northeast,Central WDA,Montour,47,45 to 64 Years,Female,2776,269,1068,493,241,388,317,705,946,41.0280182,-76.6647053
01/01/2014 12:00:00 AM,42093,Northeast,Central WDA,Montour,47,45 to 64 Years,Male,2648,189,1225,326,222,384,302,686,908,41.0280182,-76.6647053
01/01/2010 12:00:00 AM,42093,Northeast,Central WDA,Montour,47,45 to 64 Years,Female,2774,272,1139,423,229,418,293,711,940,41.0280182,-76.6647053
01/01/2014 12:00:00 AM,42093,Northeast,Central WDA,Montour,47,45 to 64 Years,Female,2788,263,1139,442,243,408,293,701,944,41.0280182,-76.6647053
01/01/2016 12:00:00 AM,42093,Northeast,Central WDA,Montour,47,45 to 64 Years,Female,2721,290,1115,423,221,384,288,672,893,41.0280182,-76.6647053
01/01/2011 12:00:00 AM,42093,Northeast,Central WDA,Montour,47,45 to 64 Years,Female,2800,251,1194,464,235,377,279,656,891,41.0280182,-76.6647053
01/01/2016 12:00:00 AM,42093,Northeast,Central WDA,Montour,47,45 to 64 Years,Male,2544,191,1213,285,157,420,278,698,855,41.0280182,-76.6647053
01/01/2013 12:00:00 AM,42093,Northeast,Central WDA,Montour,47,45 to 64 Years,Female,2803,262,1215,385,242,428,271,699,941,41.0280182,-76.6647053
01/01/2012 12:00:00 AM,42093,Northeast,Central WDA,Montour,47,45 to 64 Years,Female,2812,266,1203,398,267,411,267,678,945,41.0280182,-76.6647053
01/01/2011 12:00:00 AM,42093,Northeast,Central WDA,Montour,47,25 to 34 Years,Female,1036,92,296,199,118,105,226,331,449,41.0280182,-76.6647053
01/01/2016 12:00:00 AM,42093,Northeast,Central WDA,Montour,47,25 to 34 Years,Male,1239,107,337,230,68,274,223,497,565,41.0280182,-76.6647053
01/01/2016 12:00:00 AM,42093,Northeast,Central WDA,Montour,47,25 to 34 Years,Female,1130,81,244,213,93,278,221,499,592,41.0280182,-76.6647053
01/01/2014 12:00:00 AM,42093,Northeast,Central WDA,Montour,47,25 to 34 Years,Female,1112,89,294,187,104,227,211,438,542,41.0280182,-76.6647053
01/01/2010 12:00:00 AM,42093,Northeast,Central WDA,Montour,47,25 to 34 Years,Female,982,96,269,178,124,117,198,315,439,41.0280182,-76.6647053
01/01/2015 12:00:00 AM,42093,Northeast,Central WDA,Montour,47,25 to 34 Years,Male,1227,123,351,258,60,239,196,435,495,41.0280182,-76.6647053
01/01/2015 12:00:00 AM,42093,Northeast,Central WDA,Montour,47,25 to 34 Years,Female,1160,81,316,202,76,291,194,485,561,41.0280182,-76.6647053
01/01/2011 12:00:00 AM,42093,Northeast,Central WDA,Montour,47,35 to 44 Years,Female,1081,60,372,126,147,187,189,376,523,41.0280182,-76.6647053
01/01/2012 12:00:00 AM,42093,Northeast,Central WDA,Montour,47,35 to 44 Years,Female,1048,44,395,101,101,220,187,407,508,41.0280182,-76.6647053
01/01/2016 12:00:00 AM,42093,Northeast,Central WDA,Montour,47,35 to 44 Years,Female,1086,28,417,106,81,269,185,454,535,41.0280182,-76.6647053
01/01/2013 12:00:00 AM,42093,Northeast,Central WDA,Montour,47,35 to 44 Years,Female,1035,33,426,106,80,208,182,390,470,41.0280182,-76.6647053
01/01/2010 12:00:00 AM,42093,Northeast,Central WDA,Montour,47,35 to 44 Years,Female,1139,70,418,159,129,186,177,363,492,41.0280182,-76.6647053
01/01/2013 12:00:00 AM,42093,Northeast,Central WDA,Montour,47,25 to 34 Years,Female,1134,134,354,235,86,149,176,325,411,41.0280182,-76.6647053
01/01/2012 12:00:00 AM,42093,Northeast,Central WDA,Montour,47,25 to 34 Years,Female,1061,119,307,218,103,140,174,314,417,41.0280182,-76.6647053
01/01/2014 12:00:00 AM,42093,Northeast,Central WDA,Montour,47,35 to 44 Years,Female,1054,27,433,85,95,241,173,414,509,41.0280182,-76.6647053
01/01/2014 12:00:00 AM,42093,Northeast,Central WDA,Montour,47,25 to 34 Years,Male,1167,135,359,288,28,186,171,357,385,41.0280182,-76.6647053
01/01/2015 12:00:00 AM,42093,Northeast,Central WDA,Montour,47,35 to 44 Years,Male,988,74,326,120,125,181,162,343,468,41.0280182,-76.6647053
01/01/2016 12:00:00 AM,42093,Northeast,Central WDA,Montour,47,35 to 44 Years,Male,965,82,364,117,102,156,144,300,402,41.0280182,-76.6647053
01/01/2015 12:00:00 AM,42093,Northeast,Central WDA,Montour,47,35 to 44 Years,Female,1028,33,408,93,90,261,143,404,494,41.0280182,-76.6647053
01/01/2014 12:00:00 AM,42093,Northeast,Central WDA,Montour,47,35 to 44 Years,Male,1028,90,340,115,99,248,136,384,483,41.0280182,-76.6647053
01/01/2012 12:00:00 AM,42093,Northeast,Central WDA,Montour,47,35 to 44 Years,Male,1037,108,343,74,108,269,135,404,512,41.0280182,-76.6647053
01/01/2011 12:00:00 AM,42093,Northeast,Central WDA,Montour,47,35 to 44 Years,Male,1076,121,408,86,77,255,129,384,461,41.0280182,-76.6647053
01/01/2013 12:00:00 AM,42093,Northeast,Central WDA,Montour,47,35 to 44 Years,Male,1038,102,355,69,110,274,128,402,512,41.0280182,-76.6647053
01/01/2010 12:00:00 AM,42093,Northeast,Central WDA,Montour,47,35 to 44 Years,Male,1075,130,410,118,56,242,119,361,417,41.0280182,-76.6647053
01/01/2012 12:00:00 AM,42093,Northeast,Central WDA,Montour,47,25 to 34 Years,Male,1039,113,353,229,54,178,112,290,344,41.0280182,-76.6647053
01/01/2010 12:00:00 AM,42093,Northeast,Central WDA,Montour,47,25 to 34 Years,Male,956,93,372,152,61,175,103,278,339,41.0280182,-76.6647053
01/01/2013 12:00:00 AM,42093,Northeast,Central WDA,Montour,47,25 to 34 Years,Male,1137,92,377,350,58,175,85,260,318,41.0280182,-76.6647053
01/01/2011 12:00:00 AM,42093,Northeast,Central WDA,Montour,47,25 to 34 Years,Male,971,104,318,198,66,204,81,285,351,41.0280182,-76.6647053
01/01/2016 12:00:00 AM,42033,Northwest,North Central WDA,Clearfield,17,45 to 64 Years,Female,11405,833,6110,1515,1311,1014,622,1636,2947,41.000429,-78.4755834
01/01/2015 12:00:00 AM,42033,Northwest,North Central WDA,Clearfield,17,45 to 64 Years,Female,11482,918,6189,1442,1329,987,617,1604,2933,41.000429,-78.4755834
01/01/2010 12:00:00 AM,42033,Northwest,North Central WDA,Clearfield,17,45 to 64 Years,Male,11863,1322,6649,1378,845,1067,602,1669,2514,41.000429,-78.4755834
01/01/2014 12:00:00 AM,42033,Northwest,North Central WDA,Clearfield,17,45 to 64 Years,Female,11505,838,6419,1366,1255,1029,598,1627,2882,41.000429,-78.4755834
01/01/2011 12:00:00 AM,42033,Northwest,North Central WDA,Clearfield,17,45 to 64 Years,Male,12274,1493,6555,1418,1085,1157,566,1723,2808,41.000429,-78.4755834
01/01/2013 12:00:00 AM,42033,Northwest,North Central WDA,Clearfield,17,45 to 64 Years,Female,11485,802,6464,1428,1190,1058,543,1601,2791,41.000429,-78.4755834
01/01/2012 12:00:00 AM,42033,Northwest,North Central WDA,Clearfield,17,45 to 64 Years,Male,12481,1392,6808,1583,1120,1040,538,1578,2698,41.000429,-78.4755834
01/01/2012 12:00:00 AM,42033,Northwest,North Central WDA,Clearfield,17,45 to 64 Years,Female,11625,767,6572,1681,1067,1008,530,1538,2605,41.000429,-78.4755834
01/01/2013 12:00:00 AM,42033,Northwest,North Central WDA,Clearfield,17,45 to 64 Years,Male,12508,1160,7118,1484,1092,1126,528,1654,2746,41.000429,-78.4755834
01/01/2011 12:00:00 AM,42033,Northwest,North Central WDA,Clearfield,17,45 to 64 Years,Female,11490,886,6350,1640,1120,1036,458,1494,2614,41.000429,-78.4755834
01/01/2014 12:00:00 AM,42033,Northwest,North Central WDA,Clearfield,17,45 to 64 Years,Male,12598,1368,7074,1424,1106,1203,423,1626,2732,41.000429,-78.4755834
01/01/2016 12:00:00 AM,42033,Northwest,North Central WDA,Clearfield,17,45 to 64 Years,Male,12611,1548,6893,1500,1192,1057,421,1478,2670,41.000429,-78.4755834
01/01/2015 12:00:00 AM,42033,Northwest,North Central WDA,Clearfield,17,45 to 64 Years,Male,12771,1551,6875,1485,1231,1209,420,1629,2860,41.000429,-78.4755834
01/01/2011 12:00:00 AM,42033,Northwest,North Central WDA,Clearfield,17,35 to 44 Years,Female,5182,220,2332,936,757,527,410,937,1694,41.000429,-78.4755834
01/01/2010 12:00:00 AM,42033,Northwest,North Central WDA,Clearfield,17,45 to 64 Years,Female,11446,922,6328,1704,1054,1076,362,1438,2492,41.000429,-78.4755834
01/01/2013 12:00:00 AM,42033,Northwest,North Central WDA,Clearfield,17,35 to 44 Years,Female,4916,238,2037,955,779,554,353,907,1686,41.000429,-78.4755834
01/01/2012 12:00:00 AM,42033,Northwest,North Central WDA,Clearfield,17,35 to 44 Years,Female,5095,240,2263,921,852,487,332,819,1671,41.000429,-78.4755834
01/01/2011 12:00:00 AM,42033,Northwest,North Central WDA,Clearfield,17,25 to 34 Years,Female,4142,251,1359,965,539,710,318,1028,1567,41.000429,-78.4755834
01/01/2010 12:00:00 AM,42033,Northwest,North Central WDA,Clearfield,17,35 to 44 Years,Female,5297,231,2564,900,790,506,306,812,1602,41.000429,-78.4755834
01/01/2012 12:00:00 AM,42033,Northwest,North Central WDA,Clearfield,17,25 to 34 Years,Female,4149,253,1318,885,541,869,283,1152,1693,41.000429,-78.4755834
01/01/2011 12:00:00 AM,42033,Northwest,North Central WDA,Clearfield,17,35 to 44 Years,Male,5946,635,3189,893,391,556,282,838,1229,41.000429,-78.4755834
01/01/2014 12:00:00 AM,42033,Northwest,North Central WDA,Clearfield,17,25 to 34 Years,Female,4026,262,1246,760,607,886,265,1151,1758,41.000429,-78.4755834
01/01/2010 12:00:00 AM,42033,Northwest,North Central WDA,Clearfield,17,25 to 34 Years,Female,4151,246,1530,897,471,749,258,1007,1478,41.000429,-78.4755834
01/01/2013 12:00:00 AM,42033,Northwest,North Central WDA,Clearfield,17,25 to 34 Years,Female,4120,291,1272,878,510,917,252,1169,1679,41.000429,-78.4755834
01/01/2015 12:00:00 AM,42033,Northwest,North Central WDA,Clearfield,17,35 to 44 Years,Female,4671,272,2066,704,766,618,245,863,1629,41.000429,-78.4755834
01/01/2014 12:00:00 AM,42033,Northwest,North Central WDA,Clearfield,17,35 to 44 Years,Female,4817,309,2034,831,780,625,238,863,1643,41.000429,-78.4755834
01/01/2016 12:00:00 AM,42033,Northwest,North Central WDA,Clearfield,17,25 to 34 Years,Female,3981,384,1370,651,547,793,236,1029,1576,41.000429,-78.4755834
01/01/2010 12:00:00 AM,42033,Northwest,North Central WDA,Clearfield,17,35 to 44 Years,Male,6023,620,3328,967,434,447,227,674,1108,41.000429,-78.4755834
01/01/2012 12:00:00 AM,42033,Northwest,North Central WDA,Clearfield,17,35 to 44 Years,Male,5789,660,3009,954,457,484,225,709,1166,41.000429,-78.4755834
01/01/2014 12:00:00 AM,42033,Northwest,North Central WDA,Clearfield,17,35 to 44 Years,Male,6056,789,2991,1033,541,479,223,702,1243,41.000429,-78.4755834
01/01/2013 12:00:00 AM,42033,Northwest,North Central WDA,Clearfield,17,35 to 44 Years,Male,5852,745,2835,967,537,548,220,768,1305,41.000429,-78.4755834
01/01/2015 12:00:00 AM,42033,Northwest,North Central WDA,Clearfield,17,25 to 34 Years,Female,3989,361,1299,716,592,804,217,1021,1613,41.000429,-78.4755834
01/01/2011 12:00:00 AM,42033,Northwest,North Central WDA,Clearfield,17,25 to 34 Years,Male,5039,767,1990,871,620,599,192,791,1411,41.000429,-78.4755834
01/01/2016 12:00:00 AM,42033,Northwest,North Central WDA,Clearfield,17,35 to 44 Years,Female,4555,247,1901,723,889,610,185,795,1684,41.000429,-78.4755834
01/01/2015 12:00:00 AM,42033,Northwest,North Central WDA,Clearfield,17,35 to 44 Years,Male,5953,814,2853,1064,522,530,170,700,1222,41.000429,-78.4755834
01/01/2010 12:00:00 AM,42033,Northwest,North Central WDA,Clearfield,17,25 to 34 Years,Male,5196,819,2123,887,705,504,158,662,1367,41.000429,-78.4755834
01/01/2016 12:00:00 AM,42033,Northwest,North Central WDA,Clearfield,17,25 to 34 Years,Male,5463,675,2688,924,547,503,126,629,1176,41.000429,-78.4755834
01/01/2012 12:00:00 AM,42033,Northwest,North Central WDA,Clearfield,17,25 to 34 Years,Male,5232,789,2107,896,761,555,124,679,1440,41.000429,-78.4755834
01/01/2016 12:00:00 AM,42033,Northwest,North Central WDA,Clearfield,17,35 to 44 Years,Male,5935,906,2870,1081,473,488,117,605,1078,41.000429,-78.4755834
01/01/2014 12:00:00 AM,42033,Northwest,North Central WDA,Clearfield,17,25 to 34 Years,Male,5527,575,2571,990,810,495,86,581,1391,41.000429,-78.4755834
01/01/2015 12:00:00 AM,42033,Northwest,North Central WDA,Clearfield,17,25 to 34 Years,Male,5370,605,2632,946,603,499,85,584,1187,41.000429,-78.4755834
01/01/2013 12:00:00 AM,42033,Northwest,North Central WDA,Clearfield,17,25 to 34 Years,Male,5407,834,2179,1039,789,485,81,566,1355,41.000429,-78.4755834
01/01/2010 12:00:00 AM,42073,Northwest,West Central WDA,Lawrence,37,45 to 64 Years,Female,13478,1101,6375,2164,1301,1571,966,2537,3838,40.9932504,-80.3375411
01/01/2016 12:00:00 AM,42073,Northwest,West Central WDA,Lawrence,37,45 to 64 Years,Female,13311,785,6696,1933,1402,1563,932,2495,3897,40.9932504,-80.3375411
01/01/2014 12:00:00 AM,42073,Northwest,West Central WDA,Lawrence,37,45 to 64 Years,Female,13588,801,6859,2011,1508,1553,856,2409,3917,40.9932504,-80.3375411
01/01/2012 12:00:00 AM,42073,Northwest,West Central WDA,Lawrence,37,45 to 64 Years,Female,13580,961,6616,2271,1328,1548,856,2404,3732,40.9932504,-80.3375411
01/01/2013 12:00:00 AM,42073,Northwest,West Central WDA,Lawrence,37,45 to 64 Years,Female,13580,856,6683,2066,1489,1637,849,2486,3975,40.9932504,-80.3375411
01/01/2015 12:00:00 AM,42073,Northwest,West Central WDA,Lawrence,37,45 to 64 Years,Female,13490,809,6936,1887,1400,1622,836,2458,3858,40.9932504,-80.3375411
01/01/2011 12:00:00 AM,42073,Northwest,West Central WDA,Lawrence,37,45 to 64 Years,Female,13563,1050,6580,2112,1344,1642,835,2477,3821,40.9932504,-80.3375411
01/01/2011 12:00:00 AM,42073,Northwest,West Central WDA,Lawrence,37,45 to 64 Years,Male,12875,980,6036,2204,1118,1738,799,2537,3655,40.9932504,-80.3375411
01/01/2010 12:00:00 AM,42073,Northwest,West Central WDA,Lawrence,37,45 to 64 Years,Male,12771,979,6214,2064,934,1785,795,2580,3514,40.9932504,-80.3375411
01/01/2013 12:00:00 AM,42073,Northwest,West Central WDA,Lawrence,37,45 to 64 Years,Male,12997,1067,6161,2257,1038,1722,752,2474,3512,40.9932504,-80.3375411
01/01/2014 12:00:00 AM,42073,Northwest,West Central WDA,Lawrence,37,45 to 64 Years,Male,12975,1104,5998,2390,1149,1592,742,2334,3483,40.9932504,-80.3375411
01/01/2012 12:00:00 AM,42073,Northwest,West Central WDA,Lawrence,37,45 to 64 Years,Male,12937,1014,6186,2173,1092,1743,729,2472,3564,40.9932504,-80.3375411
01/01/2015 12:00:00 AM,42073,Northwest,West Central WDA,Lawrence,37,45 to 64 Years,Male,12842,1104,6108,2168,1104,1631,727,2358,3462,40.9932504,-80.3375411
01/01/2016 12:00:00 AM,42073,Northwest,West Central WDA,Lawrence,37,45 to 64 Years,Male,12713,1110,6273,2057,1007,1635,631,2266,3273,40.9932504,-80.3375411
01/01/2015 12:00:00 AM,42073,Northwest,West Central WDA,Lawrence,37,25 to 34 Years,Female,4596,399,1216,934,537,957,553,1510,2047,40.9932504,-80.3375411
01/01/2016 12:00:00 AM,42073,Northwest,West Central WDA,Lawrence,37,25 to 34 Years,Female,4538,373,1209,802,596,1012,546,1558,2154,40.9932504,-80.3375411
01/01/2016 12:00:00 AM,42073,Northwest,West Central WDA,Lawrence,37,35 to 44 Years,Female,5138,301,1523,1125,673,984,532,1516,2189,40.9932504,-80.3375411
01/01/2010 12:00:00 AM,42073,Northwest,West Central WDA,Lawrence,37,35 to 44 Years,Female,5783,463,2351,808,723,940,498,1438,2161,40.9932504,-80.3375411
01/01/2014 12:00:00 AM,42073,Northwest,West Central WDA,Lawrence,37,25 to 34 Years,Female,4664,375,1271,963,623,946,486,1432,2055,40.9932504,-80.3375411
01/01/2013 12:00:00 AM,42073,Northwest,West Central WDA,Lawrence,37,25 to 34 Years,Female,4664,383,1400,891,648,858,484,1342,1990,40.9932504,-80.3375411
01/01/2015 12:00:00 AM,42073,Northwest,West Central WDA,Lawrence,37,35 to 44 Years,Female,5292,323,1784,1062,637,1050,436,1486,2123,40.9932504,-80.3375411
01/01/2012 12:00:00 AM,42073,Northwest,West Central WDA,Lawrence,37,25 to 34 Years,Female,4684,393,1390,945,668,872,416,1288,1956,40.9932504,-80.3375411
01/01/2011 12:00:00 AM,42073,Northwest,West Central WDA,Lawrence,37,35 to 44 Years,Female,5743,428,2276,874,673,1081,411,1492,2165,40.9932504,-80.3375411
01/01/2014 12:00:00 AM,42073,Northwest,West Central WDA,Lawrence,37,35 to 44 Years,Female,5293,344,1769,1153,519,1101,407,1508,2027,40.9932504,-80.3375411
01/01/2013 12:00:00 AM,42073,Northwest,West Central WDA,Lawrence,37,35 to 44 Years,Female,5531,377,1942,1053,616,1164,379,1543,2159,40.9932504,-80.3375411
01/01/2012 12:00:00 AM,42073,Northwest,West Central WDA,Lawrence,37,35 to 44 Years,Female,5641,363,2035,1031,714,1145,353,1498,2212,40.9932504,-80.3375411
01/01/2011 12:00:00 AM,42073,Northwest,West Central WDA,Lawrence,37,25 to 34 Years,Female,4718,422,1458,919,617,970,332,1302,1919,40.9932504,-80.3375411
01/01/2016 12:00:00 AM,42073,Northwest,West Central WDA,Lawrence,37,35 to 44 Years,Male,4889,385,1620,1169,455,945,315,1260,1715,40.9932504,-80.3375411
01/01/2015 12:00:00 AM,42073,Northwest,West Central WDA,Lawrence,37,35 to 44 Years,Male,4988,350,1641,1146,509,1030,312,1342,1851,40.9932504,-80.3375411
01/01/2010 12:00:00 AM,42073,Northwest,West Central WDA,Lawrence,37,25 to 34 Years,Female,4643,416,1364,873,656,1053,281,1334,1990,40.9932504,-80.3375411
01/01/2016 12:00:00 AM,42073,Northwest,West Central WDA,Lawrence,37,25 to 34 Years,Male,4714,437,1634,677,738,954,274,1228,1966,40.9932504,-80.3375411
01/01/2013 12:00:00 AM,42073,Northwest,West Central WDA,Lawrence,37,25 to 34 Years,Male,4786,457,1814,755,591,903,266,1169,1760,40.9932504,-80.3375411
01/01/2015 12:00:00 AM,42073,Northwest,West Central WDA,Lawrence,37,25 to 34 Years,Male,4782,516,1700,717,684,909,256,1165,1849,40.9932504,-80.3375411
01/01/2014 12:00:00 AM,42073,Northwest,West Central WDA,Lawrence,37,25 to 34 Years,Male,4718,524,1678,686,677,898,255,1153,1830,40.9932504,-80.3375411
01/01/2012 12:00:00 AM,42073,Northwest,West Central WDA,Lawrence,37,25 to 34 Years,Male,4686,423,1786,801,516,910,250,1160,1676,40.9932504,-80.3375411
01/01/2013 12:00:00 AM,42073,Northwest,West Central WDA,Lawrence,37,35 to 44 Years,Male,5181,403,1864,951,539,1177,247,1424,1963,40.9932504,-80.3375411
01/01/2014 12:00:00 AM,42073,Northwest,West Central WDA,Lawrence,37,35 to 44 Years,Male,5117,327,1849,1054,500,1146,241,1387,1887,40.9932504,-80.3375411
01/01/2011 12:00:00 AM,42073,Northwest,West Central WDA,Lawrence,37,35 to 44 Years,Male,5594,554,2165,890,438,1319,228,1547,1985,40.9932504,-80.3375411
01/01/2010 12:00:00 AM,42073,Northwest,West Central WDA,Lawrence,37,35 to 44 Years,Male,5798,684,2247,1021,445,1174,227,1401,1846,40.9932504,-80.3375411
01/01/2012 12:00:00 AM,42073,Northwest,West Central WDA,Lawrence,37,35 to 44 Years,Male,5385,472,1977,950,468,1315,203,1518,1986,40.9932504,-80.3375411
01/01/2011 12:00:00 AM,42073,Northwest,West Central WDA,Lawrence,37,25 to 34 Years,Male,4625,421,1766,959,487,795,197,992,1479,40.9932504,-80.3375411
01/01/2010 12:00:00 AM,42073,Northwest,West Central WDA,Lawrence,37,25 to 34 Years,Male,4463,527,1646,903,453,791,143,934,1387,40.9932504,-80.3375411
01/01/2014 12:00:00 AM,42119,Lehigh Valley,Central WDA,Union,60,45 to 64 Years,Male,6296,766,2916,897,359,605,753,1358,1717,40.9647313,-77.064158
01/01/2013 12:00:00 AM,42119,Lehigh Valley,Central WDA,Union,60,45 to 64 Years,Male,6267,822,2806,852,329,725,733,1458,1787,40.9647313,-77.064158
01/01/2010 12:00:00 AM,42119,Lehigh Valley,Central WDA,Union,60,45 to 64 Years,Female,5135,525,2072,727,381,701,729,1430,1811,40.9647313,-77.064158
01/01/2016 12:00:00 AM,42119,Lehigh Valley,Central WDA,Union,60,45 to 64 Years,Male,6595,877,2871,1087,419,620,721,1341,1760,40.9647313,-77.064158
01/01/2010 12:00:00 AM,42119,Lehigh Valley,Central WDA,Union,60,45 to 64 Years,Male,6246,819,2638,904,324,882,679,1561,1885,40.9647313,-77.064158
01/01/2015 12:00:00 AM,42119,Lehigh Valley,Central WDA,Union,60,45 to 64 Years,Male,6459,955,2851,1024,368,593,668,1261,1629,40.9647313,-77.064158
01/01/2011 12:00:00 AM,42119,Lehigh Valley,Central WDA,Union,60,45 to 64 Years,Male,6278,796,2794,901,275,845,667,1512,1787,40.9647313,-77.064158
01/01/2011 12:00:00 AM,42119,Lehigh Valley,Central WDA,Union,60,45 to 64 Years,Female,5171,527,2076,754,408,782,624,1406,1814,40.9647313,-77.064158
01/01/2012 12:00:00 AM,42119,Lehigh Valley,Central WDA,Union,60,45 to 64 Years,Male,6243,840,2743,881,340,817,622,1439,1779,40.9647313,-77.064158
01/01/2014 12:00:00 AM,42119,Lehigh Valley,Central WDA,Union,60,45 to 64 Years,Female,5158,507,2060,642,538,926,485,1411,1949,40.9647313,-77.064158
01/01/2012 12:00:00 AM,42119,Lehigh Valley,Central WDA,Union,60,45 to 64 Years,Female,5267,502,2062,717,547,959,480,1439,1986,40.9647313,-77.064158
01/01/2013 12:00:00 AM,42119,Lehigh Valley,Central WDA,Union,60,45 to 64 Years,Female,5161,541,2064,703,508,878,467,1345,1853,40.9647313,-77.064158
01/01/2016 12:00:00 AM,42119,Lehigh Valley,Central WDA,Union,60,45 to 64 Years,Female,5070,503,2099,592,544,867,465,1332,1876,40.9647313,-77.064158
01/01/2015 12:00:00 AM,42119,Lehigh Valley,Central WDA,Union,60,45 to 64 Years,Female,5087,581,2128,584,598,800,396,1196,1794,40.9647313,-77.064158
01/01/2010 12:00:00 AM,42119,Lehigh Valley,Central WDA,Union,60,35 to 44 Years,Male,4158,903,1414,764,154,543,380,923,1077,40.9647313,-77.064158
01/01/2016 12:00:00 AM,42119,Lehigh Valley,Central WDA,Union,60,35 to 44 Years,Female,2105,162,635,331,281,373,323,696,977,40.9647313,-77.064158
01/01/2012 12:00:00 AM,42119,Lehigh Valley,Central WDA,Union,60,35 to 44 Years,Female,2346,193,716,452,293,387,305,692,985,40.9647313,-77.064158
01/01/2010 12:00:00 AM,42119,Lehigh Valley,Central WDA,Union,60,35 to 44 Years,Female,2414,216,943,392,222,342,299,641,863,40.9647313,-77.064158
01/01/2011 12:00:00 AM,42119,Lehigh Valley,Central WDA,Union,60,35 to 44 Years,Female,2350,152,834,454,265,370,275,645,910,40.9647313,-77.064158
01/01/2011 12:00:00 AM,42119,Lehigh Valley,Central WDA,Union,60,35 to 44 Years,Male,3995,750,1570,828,146,442,259,701,847,40.9647313,-77.064158
01/01/2016 12:00:00 AM,42119,Lehigh Valley,Central WDA,Union,60,25 to 34 Years,Female,2124,253,677,246,280,412,256,668,948,40.9647313,-77.064158
01/01/2015 12:00:00 AM,42119,Lehigh Valley,Central WDA,Union,60,25 to 34 Years,Female,2113,258,640,282,232,456,245,701,933,40.9647313,-77.064158
01/01/2012 12:00:00 AM,42119,Lehigh Valley,Central WDA,Union,60,35 to 44 Years,Male,3998,697,1651,835,161,422,232,654,815,40.9647313,-77.064158
01/01/2014 12:00:00 AM,42119,Lehigh Valley,Central WDA,Union,60,35 to 44 Years,Female,2167,132,730,415,277,386,227,613,890,40.9647313,-77.064158
01/01/2013 12:00:00 AM,42119,Lehigh Valley,Central WDA,Union,60,35 to 44 Years,Female,2194,153,740,454,253,370,224,594,847,40.9647313,-77.064158
01/01/2014 12:00:00 AM,42119,Lehigh Valley,Central WDA,Union,60,25 to 34 Years,Female,2230,216,671,357,256,509,221,730,986,40.9647313,-77.064158
01/01/2016 12:00:00 AM,42119,Lehigh Valley,Central WDA,Union,60,35 to 44 Years,Male,3957,649,1716,801,168,402,221,623,791,40.9647313,-77.064158
01/01/2013 12:00:00 AM,42119,Lehigh Valley,Central WDA,Union,60,35 to 44 Years,Male,4001,679,1779,791,199,345,208,553,752,40.9647313,-77.064158
01/01/2012 12:00:00 AM,42119,Lehigh Valley,Central WDA,Union,60,25 to 34 Years,Female,2034,176,669,372,174,443,200,643,817,40.9647313,-77.064158
01/01/2015 12:00:00 AM,42119,Lehigh Valley,Central WDA,Union,60,35 to 44 Years,Male,4024,689,1804,772,190,370,199,569,759,40.9647313,-77.064158
01/01/2015 12:00:00 AM,42119,Lehigh Valley,Central WDA,Union,60,35 to 44 Years,Female,2113,173,606,399,316,435,184,619,935,40.9647313,-77.064158
01/01/2013 12:00:00 AM,42119,Lehigh Valley,Central WDA,Union,60,25 to 34 Years,Female,2089,186,660,425,198,442,178,620,818,40.9647313,-77.064158
01/01/2014 12:00:00 AM,42119,Lehigh Valley,Central WDA,Union,60,35 to 44 Years,Male,4056,651,1807,885,193,344,176,520,713,40.9647313,-77.064158
01/01/2011 12:00:00 AM,42119,Lehigh Valley,Central WDA,Union,60,25 to 34 Years,Female,1909,167,633,375,190,391,153,544,734,40.9647313,-77.064158
01/01/2015 12:00:00 AM,42119,Lehigh Valley,Central WDA,Union,60,25 to 34 Years,Male,3598,806,1377,658,182,431,144,575,757,40.9647313,-77.064158
01/01/2014 12:00:00 AM,42119,Lehigh Valley,Central WDA,Union,60,25 to 34 Years,Male,3711,771,1431,699,174,493,143,636,810,40.9647313,-77.064158
01/01/2016 12:00:00 AM,42119,Lehigh Valley,Central WDA,Union,60,25 to 34 Years,Male,3625,749,1420,687,193,434,142,576,769,40.9647313,-77.064158
01/01/2011 12:00:00 AM,42119,Lehigh Valley,Central WDA,Union,60,25 to 34 Years,Male,4029,1017,1610,640,216,449,97,546,762,40.9647313,-77.064158
01/01/2010 12:00:00 AM,42119,Lehigh Valley,Central WDA,Union,60,25 to 34 Years,Female,1845,150,633,421,165,379,97,476,641,40.9647313,-77.064158
01/01/2012 12:00:00 AM,42119,Lehigh Valley,Central WDA,Union,60,25 to 34 Years,Male,3882,971,1503,667,140,512,89,601,741,40.9647313,-77.064158
01/01/2013 12:00:00 AM,42119,Lehigh Valley,Central WDA,Union,60,25 to 34 Years,Male,3887,947,1527,620,188,518,87,605,793,40.9647313,-77.064158
01/01/2010 12:00:00 AM,42119,Lehigh Valley,Central WDA,Union,60,25 to 34 Years,Male,3886,978,1476,724,212,429,67,496,708,40.9647313,-77.064158
01/01/2016 12:00:00 AM,42025,Northeast,Pocono Counties WDA,Carbon,13,45 to 64 Years,Female,9959,691,4536,1871,1281,941,639,1580,2861,40.919367,-75.7110704
01/01/2013 12:00:00 AM,42025,Northeast,Pocono Counties WDA,Carbon,13,45 to 64 Years,Female,10002,946,4538,1877,1136,870,635,1505,2641,40.919367,-75.7110704
01/01/2010 12:00:00 AM,42025,Northeast,Pocono Counties WDA,Carbon,13,45 to 64 Years,Female,9432,971,4452,1764,845,767,633,1400,2245,40.919367,-75.7110704
01/01/2011 12:00:00 AM,42025,Northeast,Pocono Counties WDA,Carbon,13,45 to 64 Years,Female,9804,1050,4317,1912,977,934,614,1548,2525,40.919367,-75.7110704
01/01/2012 12:00:00 AM,42025,Northeast,Pocono Counties WDA,Carbon,13,45 to 64 Years,Female,9917,1027,4344,2008,1043,904,591,1495,2538,40.919367,-75.7110704
01/01/2015 12:00:00 AM,42025,Northeast,Pocono Counties WDA,Carbon,13,45 to 64 Years,Male,9987,1185,4660,1519,1073,968,582,1550,2623,40.919367,-75.7110704
01/01/2015 12:00:00 AM,42025,Northeast,Pocono Counties WDA,Carbon,13,45 to 64 Years,Female,10002,828,4388,1929,1307,983,567,1550,2857,40.919367,-75.7110704
01/01/2014 12:00:00 AM,42025,Northeast,Pocono Counties WDA,Carbon,13,45 to 64 Years,Male,10125,1239,4630,1576,1017,1122,541,1663,2680,40.919367,-75.7110704
01/01/2012 12:00:00 AM,42025,Northeast,Pocono Counties WDA,Carbon,13,45 to 64 Years,Male,10011,1366,4539,1701,831,1038,536,1574,2405,40.919367,-75.7110704
01/01/2013 12:00:00 AM,42025,Northeast,Pocono Counties WDA,Carbon,13,45 to 64 Years,Male,10136,1347,4506,1717,937,1099,530,1629,2566,40.919367,-75.7110704
01/01/2016 12:00:00 AM,42025,Northeast,Pocono Counties WDA,Carbon,13,45 to 64 Years,Male,10024,1215,4653,1520,988,1125,523,1648,2636,40.919367,-75.7110704
01/01/2014 12:00:00 AM,42025,Northeast,Pocono Counties WDA,Carbon,13,45 to 64 Years,Female,10046,832,4453,1888,1334,1033,506,1539,2873,40.919367,-75.7110704
01/01/2011 12:00:00 AM,42025,Northeast,Pocono Counties WDA,Carbon,13,45 to 64 Years,Male,9770,1366,4463,1630,851,1030,430,1460,2311,40.919367,-75.7110704
01/01/2012 12:00:00 AM,42025,Northeast,Pocono Counties WDA,Carbon,13,35 to 44 Years,Female,4384,181,1617,1117,574,534,361,895,1469,40.919367,-75.7110704
01/01/2015 12:00:00 AM,42025,Northeast,Pocono Counties WDA,Carbon,13,35 to 44 Years,Female,3979,169,1442,1050,445,513,360,873,1318,40.919367,-75.7110704
01/01/2010 12:00:00 AM,42025,Northeast,Pocono Counties WDA,Carbon,13,45 to 64 Years,Male,9594,1363,4583,1558,735,996,359,1355,2090,40.919367,-75.7110704
01/01/2012 12:00:00 AM,42025,Northeast,Pocono Counties WDA,Carbon,13,25 to 34 Years,Female,3289,135,1019,671,438,668,358,1026,1464,40.919367,-75.7110704
01/01/2016 12:00:00 AM,42025,Northeast,Pocono Counties WDA,Carbon,13,35 to 44 Years,Female,3825,136,1365,914,451,606,353,959,1410,40.919367,-75.7110704
01/01/2011 12:00:00 AM,42025,Northeast,Pocono Counties WDA,Carbon,13,35 to 44 Years,Male,4363,218,2043,826,540,412,324,736,1276,40.919367,-75.7110704
01/01/2013 12:00:00 AM,42025,Northeast,Pocono Counties WDA,Carbon,13,25 to 34 Years,Female,3302,171,996,720,460,645,310,955,1415,40.919367,-75.7110704
01/01/2010 12:00:00 AM,42025,Northeast,Pocono Counties WDA,Carbon,13,35 to 44 Years,Female,4724,160,1974,836,754,695,305,1000,1754,40.919367,-75.7110704
01/01/2016 12:00:00 AM,42025,Northeast,Pocono Counties WDA,Carbon,13,25 to 34 Years,Female,3385,265,1066,668,526,556,304,860,1386,40.919367,-75.7110704
01/01/2015 12:00:00 AM,42025,Northeast,Pocono Counties WDA,Carbon,13,25 to 34 Years,Female,3406,153,1125,663,549,615,301,916,1465,40.919367,-75.7110704
01/01/2013 12:00:00 AM,42025,Northeast,Pocono Counties WDA,Carbon,13,35 to 44 Years,Female,4164,210,1620,1044,511,478,301,779,1290,40.919367,-75.7110704
01/01/2014 12:00:00 AM,42025,Northeast,Pocono Counties WDA,Carbon,13,25 to 34 Years,Female,3372,148,1145,681,521,586,291,877,1398,40.919367,-75.7110704
01/01/2012 12:00:00 AM,42025,Northeast,Pocono Counties WDA,Carbon,13,35 to 44 Years,Male,4273,251,1943,849,509,432,289,721,1230,40.919367,-75.7110704
01/01/2010 12:00:00 AM,42025,Northeast,Pocono Counties WDA,Carbon,13,35 to 44 Years,Male,4460,248,2172,823,488,448,281,729,1217,40.919367,-75.7110704
01/01/2014 12:00:00 AM,42025,Northeast,Pocono Counties WDA,Carbon,13,35 to 44 Years,Female,4060,142,1544,1121,460,519,274,793,1253,40.919367,-75.7110704
01/01/2011 12:00:00 AM,42025,Northeast,Pocono Counties WDA,Carbon,13,35 to 44 Years,Female,4537,211,1749,931,718,670,258,928,1646,40.919367,-75.7110704
01/01/2011 12:00:00 AM,42025,Northeast,Pocono Counties WDA,Carbon,13,25 to 34 Years,Female,3342,71,1160,776,476,601,258,859,1335,40.919367,-75.7110704
01/01/2010 12:00:00 AM,42025,Northeast,Pocono Counties WDA,Carbon,13,25 to 34 Years,Female,3333,82,1234,752,487,559,219,778,1265,40.919367,-75.7110704
01/01/2014 12:00:00 AM,42025,Northeast,Pocono Counties WDA,Carbon,13,35 to 44 Years,Male,4151,278,2034,768,386,468,217,685,1071,40.919367,-75.7110704
01/01/2013 12:00:00 AM,42025,Northeast,Pocono Counties WDA,Carbon,13,35 to 44 Years,Male,4238,226,2090,785,495,425,217,642,1137,40.919367,-75.7110704
01/01/2016 12:00:00 AM,42025,Northeast,Pocono Counties WDA,Carbon,13,25 to 34 Years,Male,3491,418,1505,626,390,379,173,552,942,40.919367,-75.7110704
01/01/2015 12:00:00 AM,42025,Northeast,Pocono Counties WDA,Carbon,13,35 to 44 Years,Male,4039,355,2009,610,429,475,161,636,1065,40.919367,-75.7110704
01/01/2010 12:00:00 AM,42025,Northeast,Pocono Counties WDA,Carbon,13,25 to 34 Years,Male,3516,287,1629,610,556,302,132,434,990,40.919367,-75.7110704
01/01/2016 12:00:00 AM,42025,Northeast,Pocono Counties WDA,Carbon,13,35 to 44 Years,Male,3913,278,2049,573,403,485,125,610,1013,40.919367,-75.7110704
01/01/2014 12:00:00 AM,42025,Northeast,Pocono Counties WDA,Carbon,13,25 to 34 Years,Male,3453,230,1610,649,467,400,97,497,964,40.919367,-75.7110704
01/01/2015 12:00:00 AM,42025,Northeast,Pocono Counties WDA,Carbon,13,25 to 34 Years,Male,3434,470,1439,581,388,465,91,556,944,40.919367,-75.7110704
01/01/2011 12:00:00 AM,42025,Northeast,Pocono Counties WDA,Carbon,13,25 to 34 Years,Male,3433,282,1479,607,550,427,88,515,1065,40.919367,-75.7110704
01/01/2013 12:00:00 AM,42025,Northeast,Pocono Counties WDA,Carbon,13,25 to 34 Years,Male,3371,242,1595,618,343,497,76,573,916,40.919367,-75.7110704
01/01/2012 12:00:00 AM,42025,Northeast,Pocono Counties WDA,Carbon,13,25 to 34 Years,Male,3444,303,1554,611,452,451,73,524,976,40.919367,-75.7110704
01/01/2016 12:00:00 AM,42027,Northwest,Central WDA,Centre,14,45 to 64 Years,Male,18127,887,6720,2059,1120,3402,3939,7341,8461,40.9193135,-77.8250011
01/01/2014 12:00:00 AM,42027,Northwest,Central WDA,Centre,14,45 to 64 Years,Male,17354,1048,6758,1759,1187,3050,3552,6602,7789,40.9193135,-77.8250011
01/01/2012 12:00:00 AM,42027,Northwest,Central WDA,Centre,14,45 to 64 Years,Male,16554,1139,6114,1750,1249,2762,3540,6302,7551,40.9193135,-77.8250011
01/01/2010 12:00:00 AM,42027,Northwest,Central WDA,Centre,14,45 to 64 Years,Male,15936,1235,5603,1648,1222,2707,3521,6228,7450,40.9193135,-77.8250011
01/01/2015 12:00:00 AM,42027,Northwest,Central WDA,Centre,14,45 to 64 Years,Male,17776,953,6905,2002,1068,3328,3520,6848,7916,40.9193135,-77.8250011
01/01/2013 12:00:00 AM,42027,Northwest,Central WDA,Centre,14,45 to 64 Years,Male,16897,1180,6367,1642,1160,3030,3518,6548,7708,40.9193135,-77.8250011
01/01/2011 12:00:00 AM,42027,Northwest,Central WDA,Centre,14,45 to 64 Years,Male,16107,1327,5927,1576,1195,2598,3484,6082,7277,40.9193135,-77.8250011
01/01/2016 12:00:00 AM,42027,Northwest,Central WDA,Centre,14,45 to 64 Years,Female,17319,999,5648,2386,1489,3593,3204,6797,8286,40.9193135,-77.8250011
01/01/2014 12:00:00 AM,42027,Northwest,Central WDA,Centre,14,45 to 64 Years,Female,16856,1027,5795,2454,1518,3119,2943,6062,7580,40.9193135,-77.8250011
01/01/2015 12:00:00 AM,42027,Northwest,Central WDA,Centre,14,45 to 64 Years,Female,17111,993,5600,2448,1607,3535,2928,6463,8070,40.9193135,-77.8250011
01/01/2013 12:00:00 AM,42027,Northwest,Central WDA,Centre,14,45 to 64 Years,Female,16535,1091,5847,2355,1409,3031,2802,5833,7242,40.9193135,-77.8250011
01/01/2012 12:00:00 AM,42027,Northwest,Central WDA,Centre,14,45 to 64 Years,Female,16169,897,5888,2427,1363,2927,2667,5594,6957,40.9193135,-77.8250011
01/01/2011 12:00:00 AM,42027,Northwest,Central WDA,Centre,14,45 to 64 Years,Female,15803,879,5899,2326,1264,2812,2623,5435,6699,40.9193135,-77.8250011
01/01/2010 12:00:00 AM,42027,Northwest,Central WDA,Centre,14,45 to 64 Years,Female,15550,1003,5783,2304,1050,2820,2590,5410,6460,40.9193135,-77.8250011
01/01/2015 12:00:00 AM,42027,Northwest,Central WDA,Centre,14,25 to 34 Years,Male,11913,694,2936,1403,1277,3173,2430,5603,6880,40.9193135,-77.8250011
01/01/2016 12:00:00 AM,42027,Northwest,Central WDA,Centre,14,25 to 34 Years,Male,12573,818,3294,1299,1355,3431,2376,5807,7162,40.9193135,-77.8250011
01/01/2014 12:00:00 AM,42027,Northwest,Central WDA,Centre,14,25 to 34 Years,Male,11057,520,2654,1390,1199,2939,2355,5294,6493,40.9193135,-77.8250011
01/01/2012 12:00:00 AM,42027,Northwest,Central WDA,Centre,14,25 to 34 Years,Male,10246,493,2251,1497,811,2924,2270,5194,6005,40.9193135,-77.8250011
01/01/2013 12:00:00 AM,42027,Northwest,Central WDA,Centre,14,25 to 34 Years,Male,10479,475,2367,1398,1028,2949,2262,5211,6239,40.9193135,-77.8250011
01/01/2016 12:00:00 AM,42027,Northwest,Central WDA,Centre,14,25 to 34 Years,Female,9436,460,1798,1185,800,3051,2142,5193,5993,40.9193135,-77.8250011
01/01/2011 12:00:00 AM,42027,Northwest,Central WDA,Centre,14,25 to 34 Years,Male,9982,414,2221,1573,634,3054,2086,5140,5774,40.9193135,-77.8250011
01/01/2016 12:00:00 AM,42027,Northwest,Central WDA,Centre,14,35 to 44 Years,Male,9024,666,2357,1071,601,2252,2077,4329,4930,40.9193135,-77.8250011
01/01/2015 12:00:00 AM,42027,Northwest,Central WDA,Centre,14,35 to 44 Years,Male,8882,620,2447,1130,626,1988,2071,4059,4685,40.9193135,-77.8250011
01/01/2015 12:00:00 AM,42027,Northwest,Central WDA,Centre,14,25 to 34 Years,Female,9045,454,1617,1122,796,2998,2058,5056,5852,40.9193135,-77.8250011
01/01/2013 12:00:00 AM,42027,Northwest,Central WDA,Centre,14,25 to 34 Years,Female,8475,395,1381,1199,694,2757,2049,4806,5500,40.9193135,-77.8250011
01/01/2012 12:00:00 AM,42027,Northwest,Central WDA,Centre,14,25 to 34 Years,Female,8308,375,1293,1138,752,2821,1929,4750,5502,40.9193135,-77.8250011
01/01/2014 12:00:00 AM,42027,Northwest,Central WDA,Centre,14,25 to 34 Years,Female,8673,397,1540,1180,773,2860,1923,4783,5556,40.9193135,-77.8250011
01/01/2010 12:00:00 AM,42027,Northwest,Central WDA,Centre,14,25 to 34 Years,Male,9939,452,2298,1440,759,3104,1886,4990,5749,40.9193135,-77.8250011
01/01/2016 12:00:00 AM,42027,Northwest,Central WDA,Centre,14,35 to 44 Years,Female,7494,312,1318,880,1076,2035,1873,3908,4984,40.9193135,-77.8250011
01/01/2011 12:00:00 AM,42027,Northwest,Central WDA,Centre,14,25 to 34 Years,Female,8119,298,1290,1089,687,2906,1849,4755,5442,40.9193135,-77.8250011
01/01/2010 12:00:00 AM,42027,Northwest,Central WDA,Centre,14,25 to 34 Years,Female,8095,243,1385,1059,773,2819,1816,4635,5408,40.9193135,-77.8250011
01/01/2015 12:00:00 AM,42027,Northwest,Central WDA,Centre,14,35 to 44 Years,Female,7526,298,1429,1061,934,1992,1812,3804,4738,40.9193135,-77.8250011
01/01/2014 12:00:00 AM,42027,Northwest,Central WDA,Centre,14,35 to 44 Years,Male,8688,543,2471,1243,682,1945,1804,3749,4431,40.9193135,-77.8250011
01/01/2014 12:00:00 AM,42027,Northwest,Central WDA,Centre,14,35 to 44 Years,Female,7395,277,1527,996,877,1994,1724,3718,4595,40.9193135,-77.8250011
01/01/2010 12:00:00 AM,42027,Northwest,Central WDA,Centre,14,35 to 44 Years,Male,8638,474,2955,1316,671,1551,1671,3222,3893,40.9193135,-77.8250011
01/01/2013 12:00:00 AM,42027,Northwest,Central WDA,Centre,14,35 to 44 Years,Female,7492,304,1798,967,798,1962,1663,3625,4423,40.9193135,-77.8250011
01/01/2013 12:00:00 AM,42027,Northwest,Central WDA,Centre,14,35 to 44 Years,Male,8612,542,2677,1263,623,1894,1613,3507,4130,40.9193135,-77.8250011
01/01/2011 12:00:00 AM,42027,Northwest,Central WDA,Centre,14,35 to 44 Years,Male,8561,450,2978,1341,595,1623,1574,3197,3792,40.9193135,-77.8250011
01/01/2012 12:00:00 AM,42027,Northwest,Central WDA,Centre,14,35 to 44 Years,Female,7644,322,2113,935,784,1955,1535,3490,4274,40.9193135,-77.8250011
01/01/2012 12:00:00 AM,42027,Northwest,Central WDA,Centre,14,35 to 44 Years,Male,8572,468,2829,1291,674,1815,1495,3310,3984,40.9193135,-77.8250011
01/01/2010 12:00:00 AM,42027,Northwest,Central WDA,Centre,14,35 to 44 Years,Female,7840,317,2203,1155,709,2002,1454,3456,4165,40.9193135,-77.8250011
01/01/2011 12:00:00 AM,42027,Northwest,Central WDA,Centre,14,35 to 44 Years,Female,7653,293,2260,1108,641,1919,1432,3351,3992,40.9193135,-77.8250011
01/01/2016 12:00:00 AM,42019,Southwest,Tri-County WDA,Butler,10,45 to 64 Years,Female,28279,1245,9680,4910,3450,5699,3295,8994,12444,40.9108318,-79.9171178
01/01/2015 12:00:00 AM,42019,Southwest,Tri-County WDA,Butler,10,45 to 64 Years,Male,28033,1588,10467,4453,2596,5696,3233,8929,11525,40.9108318,-79.9171178
01/01/2016 12:00:00 AM,42019,Southwest,Tri-County WDA,Butler,10,45 to 64 Years,Male,27990,1477,10102,4593,2609,5981,3228,9209,11818,40.9108318,-79.9171178
01/01/2014 12:00:00 AM,42019,Southwest,Tri-County WDA,Butler,10,45 to 64 Years,Female,27877,1288,9945,4794,3386,5362,3102,8464,11850,40.9108318,-79.9171178
01/01/2014 12:00:00 AM,42019,Southwest,Tri-County WDA,Butler,10,45 to 64 Years,Male,27871,1426,10447,4823,2422,5698,3055,8753,11175,40.9108318,-79.9171178
01/01/2015 12:00:00 AM,42019,Southwest,Tri-County WDA,Butler,10,45 to 64 Years,Female,28099,1253,9939,4977,3251,5632,3047,8679,11930,40.9108318,-79.9171178
01/01/2013 12:00:00 AM,42019,Southwest,Tri-County WDA,Butler,10,45 to 64 Years,Male,27527,1421,10549,4861,2347,5536,2813,8349,10696,40.9108318,-79.9171178
01/01/2013 12:00:00 AM,42019,Southwest,Tri-County WDA,Butler,10,45 to 64 Years,Female,27580,1321,10269,4872,3236,5076,2806,7882,11118,40.9108318,-79.9171178
01/01/2010 12:00:00 AM,42019,Southwest,Tri-County WDA,Butler,10,45 to 64 Years,Male,26083,1407,10106,4599,2212,5073,2686,7759,9971,40.9108318,-79.9171178
01/01/2010 12:00:00 AM,42019,Southwest,Tri-County WDA,Butler,10,45 to 64 Years,Female,26114,1258,10710,4278,2797,4407,2664,7071,9868,40.9108318,-79.9171178
01/01/2011 12:00:00 AM,42019,Southwest,Tri-County WDA,Butler,10,45 to 64 Years,Male,26638,1453,10582,4516,2189,5248,2650,7898,10087,40.9108318,-79.9171178
01/01/2012 12:00:00 AM,42019,Southwest,Tri-County WDA,Butler,10,45 to 64 Years,Male,27109,1440,10617,4642,2255,5555,2600,8155,10410,40.9108318,-79.9171178
01/01/2012 12:00:00 AM,42019,Southwest,Tri-County WDA,Butler,10,45 to 64 Years,Female,27147,1300,10422,4780,3151,4923,2571,7494,10645,40.9108318,-79.9171178
01/01/2011 12:00:00 AM,42019,Southwest,Tri-County WDA,Butler,10,45 to 64 Years,Female,26671,1268,10870,4438,2824,4706,2565,7271,10095,40.9108318,-79.9171178
01/01/2016 12:00:00 AM,42019,Southwest,Tri-County WDA,Butler,10,35 to 44 Years,Female,11234,314,2096,1888,1435,3403,2098,5501,6936,40.9108318,-79.9171178
01/01/2015 12:00:00 AM,42019,Southwest,Tri-County WDA,Butler,10,35 to 44 Years,Female,11521,313,2123,2009,1380,3697,1999,5696,7076,40.9108318,-79.9171178
01/01/2014 12:00:00 AM,42019,Southwest,Tri-County WDA,Butler,10,35 to 44 Years,Female,11890,319,2446,2079,1344,3772,1930,5702,7046,40.9108318,-79.9171178
01/01/2013 12:00:00 AM,42019,Southwest,Tri-County WDA,Butler,10,35 to 44 Years,Female,12155,419,2741,2041,1330,3802,1822,5624,6954,40.9108318,-79.9171178
01/01/2012 12:00:00 AM,42019,Southwest,Tri-County WDA,Butler,10,35 to 44 Years,Female,12553,532,2859,2104,1570,3671,1817,5488,7058,40.9108318,-79.9171178
01/01/2016 12:00:00 AM,42019,Southwest,Tri-County WDA,Butler,10,35 to 44 Years,Male,11170,495,3141,1521,1126,3153,1734,4887,6013,40.9108318,-79.9171178
01/01/2011 12:00:00 AM,42019,Southwest,Tri-County WDA,Butler,10,35 to 44 Years,Female,12979,534,3034,2190,1726,3781,1714,5495,7221,40.9108318,-79.9171178
01/01/2010 12:00:00 AM,42019,Southwest,Tri-County WDA,Butler,10,35 to 44 Years,Female,13239,599,3518,2321,1748,3502,1551,5053,6801,40.9108318,-79.9171178
01/01/2016 12:00:00 AM,42019,Southwest,Tri-County WDA,Butler,10,25 to 34 Years,Female,9825,249,1638,1805,1242,3398,1493,4891,6133,40.9108318,-79.9171178
01/01/2015 12:00:00 AM,42019,Southwest,Tri-County WDA,Butler,10,35 to 44 Years,Male,11317,594,3321,1661,1186,3097,1458,4555,5741,40.9108318,-79.9171178
01/01/2014 12:00:00 AM,42019,Southwest,Tri-County WDA,Butler,10,35 to 44 Years,Male,11485,552,3610,1639,1213,3025,1446,4471,5684,40.9108318,-79.9171178
01/01/2013 12:00:00 AM,42019,Southwest,Tri-County WDA,Butler,10,35 to 44 Years,Male,11782,582,3727,1694,1283,3101,1395,4496,5779,40.9108318,-79.9171178
01/01/2015 12:00:00 AM,42019,Southwest,Tri-County WDA,Butler,10,25 to 34 Years,Female,9726,295,1681,1878,1254,3255,1363,4618,5872,40.9108318,-79.9171178
01/01/2012 12:00:00 AM,42019,Southwest,Tri-County WDA,Butler,10,35 to 44 Years,Male,12172,572,3900,1873,1355,3114,1358,4472,5827,40.9108318,-79.9171178
01/01/2010 12:00:00 AM,42019,Southwest,Tri-County WDA,Butler,10,35 to 44 Years,Male,12940,659,4265,1966,1363,3381,1306,4687,6050,40.9108318,-79.9171178
01/01/2014 12:00:00 AM,42019,Southwest,Tri-County WDA,Butler,10,25 to 34 Years,Female,9509,314,1651,1733,1342,3177,1292,4469,5811,40.9108318,-79.9171178
01/01/2011 12:00:00 AM,42019,Southwest,Tri-County WDA,Butler,10,35 to 44 Years,Male,12579,661,4002,1942,1311,3394,1269,4663,5974,40.9108318,-79.9171178
01/01/2013 12:00:00 AM,42019,Southwest,Tri-County WDA,Butler,10,25 to 34 Years,Female,9357,393,1682,1714,1408,2977,1183,4160,5568,40.9108318,-79.9171178
01/01/2012 12:00:00 AM,42019,Southwest,Tri-County WDA,Butler,10,25 to 34 Years,Female,9238,350,1621,1613,1588,3013,1053,4066,5654,40.9108318,-79.9171178
01/01/2010 12:00:00 AM,42019,Southwest,Tri-County WDA,Butler,10,25 to 34 Years,Female,9353,444,1706,1566,1530,3067,1040,4107,5637,40.9108318,-79.9171178
01/01/2011 12:00:00 AM,42019,Southwest,Tri-County WDA,Butler,10,25 to 34 Years,Female,9343,387,1856,1535,1480,3106,979,4085,5565,40.9108318,-79.9171178
01/01/2016 12:00:00 AM,42019,Southwest,Tri-County WDA,Butler,10,25 to 34 Years,Male,10392,466,3061,2070,1169,2760,866,3626,4795,40.9108318,-79.9171178
01/01/2015 12:00:00 AM,42019,Southwest,Tri-County WDA,Butler,10,25 to 34 Years,Male,10142,505,3059,1893,1076,2772,837,3609,4685,40.9108318,-79.9171178
01/01/2014 12:00:00 AM,42019,Southwest,Tri-County WDA,Butler,10,25 to 34 Years,Male,9969,510,3168,1975,969,2549,798,3347,4316,40.9108318,-79.9171178
01/01/2012 12:00:00 AM,42019,Southwest,Tri-County WDA,Butler,10,25 to 34 Years,Male,9504,463,3134,1740,981,2419,767,3186,4167,40.9108318,-79.9171178
01/01/2013 12:00:00 AM,42019,Southwest,Tri-County WDA,Butler,10,25 to 34 Years,Male,9766,477,3133,1887,1058,2452,759,3211,4269,40.9108318,-79.9171178
01/01/2010 12:00:00 AM,42019,Southwest,Tri-County WDA,Butler,10,25 to 34 Years,Male,9341,524,2911,1694,937,2521,754,3275,4212,40.9108318,-79.9171178
01/01/2011 12:00:00 AM,42019,Southwest,Tri-County WDA,Butler,10,25 to 34 Years,Male,9443,534,3028,1677,985,2479,740,3219,4204,40.9108318,-79.9171178
01/01/2016 12:00:00 AM,42097,Lehigh Valley,Central WDA,Northumberland,49,45 to 64 Years,Female,13386,1348,6708,1909,1294,1327,800,2127,3421,40.8515093,-76.7118842
01/01/2015 12:00:00 AM,42097,Lehigh Valley,Central WDA,Northumberland,49,45 to 64 Years,Female,13532,1482,6687,2081,1197,1330,755,2085,3282,40.8515093,-76.7118842
01/01/2010 12:00:00 AM,42097,Lehigh Valley,Central WDA,Northumberland,49,45 to 64 Years,Male,13520,1611,7062,2021,997,1118,711,1829,2826,40.8515093,-76.7118842
01/01/2011 12:00:00 AM,42097,Lehigh Valley,Central WDA,Northumberland,49,45 to 64 Years,Male,13717,1582,7044,1886,1186,1311,708,2019,3205,40.8515093,-76.7118842
01/01/2013 12:00:00 AM,42097,Lehigh Valley,Central WDA,Northumberland,49,45 to 64 Years,Male,14004,1603,7503,1737,997,1498,666,2164,3161,40.8515093,-76.7118842
01/01/2014 12:00:00 AM,42097,Lehigh Valley,Central WDA,Northumberland,49,45 to 64 Years,Female,13652,1519,7058,1904,1259,1256,656,1912,3171,40.8515093,-76.7118842
01/01/2010 12:00:00 AM,42097,Lehigh Valley,Central WDA,Northumberland,49,45 to 64 Years,Female,13449,1399,7386,1929,938,1174,623,1797,2735,40.8515093,-76.7118842
01/01/2015 12:00:00 AM,42097,Lehigh Valley,Central WDA,Northumberland,49,45 to 64 Years,Male,13880,1872,7409,1623,1008,1355,613,1968,2976,40.8515093,-76.7118842
01/01/2016 12:00:00 AM,42097,Lehigh Valley,Central WDA,Northumberland,49,35 to 44 Years,Female,5261,316,2051,936,678,676,604,1280,1958,40.8515093,-76.7118842
01/01/2011 12:00:00 AM,42097,Lehigh Valley,Central WDA,Northumberland,49,45 to 64 Years,Female,13569,1360,7388,1959,1007,1254,601,1855,2862,40.8515093,-76.7118842
01/01/2014 12:00:00 AM,42097,Lehigh Valley,Central WDA,Northumberland,49,45 to 64 Years,Male,13980,1734,7619,1593,994,1441,599,2040,3034,40.8515093,-76.7118842
01/01/2012 12:00:00 AM,42097,Lehigh Valley,Central WDA,Northumberland,49,45 to 64 Years,Male,13952,1626,7404,1913,1013,1399,597,1996,3009,40.8515093,-76.7118842
01/01/2013 12:00:00 AM,42097,Lehigh Valley,Central WDA,Northumberland,49,45 to 64 Years,Female,13636,1523,7242,1847,1256,1199,569,1768,3024,40.8515093,-76.7118842
01/01/2016 12:00:00 AM,42097,Lehigh Valley,Central WDA,Northumberland,49,45 to 64 Years,Male,13864,1746,7590,1709,974,1297,548,1845,2819,40.8515093,-76.7118842
01/01/2012 12:00:00 AM,42097,Lehigh Valley,Central WDA,Northumberland,49,45 to 64 Years,Female,13599,1455,7438,1764,1138,1261,543,1804,2942,40.8515093,-76.7118842
01/01/2015 12:00:00 AM,42097,Lehigh Valley,Central WDA,Northumberland,49,35 to 44 Years,Female,5310,280,2160,922,721,689,538,1227,1948,40.8515093,-76.7118842
01/01/2014 12:00:00 AM,42097,Lehigh Valley,Central WDA,Northumberland,49,35 to 44 Years,Female,5435,289,2283,889,722,791,461,1252,1974,40.8515093,-76.7118842
01/01/2013 12:00:00 AM,42097,Lehigh Valley,Central WDA,Northumberland,49,25 to 34 Years,Female,5110,509,1727,951,565,911,447,1358,1923,40.8515093,-76.7118842
01/01/2011 12:00:00 AM,42097,Lehigh Valley,Central WDA,Northumberland,49,25 to 34 Years,Female,4998,452,1961,777,572,809,427,1236,1808,40.8515093,-76.7118842
01/01/2014 12:00:00 AM,42097,Lehigh Valley,Central WDA,Northumberland,49,25 to 34 Years,Female,5102,458,1790,872,590,970,422,1392,1982,40.8515093,-76.7118842
01/01/2012 12:00:00 AM,42097,Lehigh Valley,Central WDA,Northumberland,49,25 to 34 Years,Female,5036,397,1950,853,556,865,415,1280,1836,40.8515093,-76.7118842
01/01/2015 12:00:00 AM,42097,Lehigh Valley,Central WDA,Northumberland,49,25 to 34 Years,Female,5099,459,1779,906,656,897,402,1299,1955,40.8515093,-76.7118842
01/01/2016 12:00:00 AM,42097,Lehigh Valley,Central WDA,Northumberland,49,25 to 34 Years,Female,5051,514,1868,790,602,904,373,1277,1879,40.8515093,-76.7118842
01/01/2013 12:00:00 AM,42097,Lehigh Valley,Central WDA,Northumberland,49,35 to 44 Years,Female,5614,306,2276,1063,848,770,351,1121,1969,40.8515093,-76.7118842
01/01/2016 12:00:00 AM,42097,Lehigh Valley,Central WDA,Northumberland,49,35 to 44 Years,Male,5908,688,3101,692,422,655,350,1005,1427,40.8515093,-76.7118842
01/01/2010 12:00:00 AM,42097,Lehigh Valley,Central WDA,Northumberland,49,25 to 34 Years,Female,4940,533,2000,726,571,776,334,1110,1681,40.8515093,-76.7118842
01/01/2012 12:00:00 AM,42097,Lehigh Valley,Central WDA,Northumberland,49,35 to 44 Years,Female,5722,364,2397,1079,796,754,332,1086,1882,40.8515093,-76.7118842
01/01/2015 12:00:00 AM,42097,Lehigh Valley,Central WDA,Northumberland,49,25 to 34 Years,Male,6133,923,2856,669,604,750,331,1081,1685,40.8515093,-76.7118842
01/01/2010 12:00:00 AM,42097,Lehigh Valley,Central WDA,Northumberland,49,35 to 44 Years,Female,6016,505,2638,1155,758,661,299,960,1718,40.8515093,-76.7118842
01/01/2011 12:00:00 AM,42097,Lehigh Valley,Central WDA,Northumberland,49,35 to 44 Years,Female,5843,457,2504,1060,767,757,298,1055,1822,40.8515093,-76.7118842
01/01/2010 12:00:00 AM,42097,Lehigh Valley,Central WDA,Northumberland,49,35 to 44 Years,Male,6527,744,3374,1054,448,609,298,907,1355,40.8515093,-76.7118842
01/01/2014 12:00:00 AM,42097,Lehigh Valley,Central WDA,Northumberland,49,25 to 34 Years,Male,6006,809,2810,764,525,805,293,1098,1623,40.8515093,-76.7118842
01/01/2012 12:00:00 AM,42097,Lehigh Valley,Central WDA,Northumberland,49,25 to 34 Years,Male,5833,817,2885,686,337,837,271,1108,1445,40.8515093,-76.7118842
01/01/2013 12:00:00 AM,42097,Lehigh Valley,Central WDA,Northumberland,49,25 to 34 Years,Male,5865,692,2864,739,483,818,269,1087,1570,40.8515093,-76.7118842
01/01/2015 12:00:00 AM,42097,Lehigh Valley,Central WDA,Northumberland,49,35 to 44 Years,Male,6118,680,3329,814,443,590,262,852,1295,40.8515093,-76.7118842
01/01/2014 12:00:00 AM,42097,Lehigh Valley,Central WDA,Northumberland,49,35 to 44 Years,Male,6125,588,3468,853,409,546,261,807,1216,40.8515093,-76.7118842
01/01/2011 12:00:00 AM,42097,Lehigh Valley,Central WDA,Northumberland,49,35 to 44 Years,Male,6453,664,3449,1030,409,659,242,901,1310,40.8515093,-76.7118842
01/01/2012 12:00:00 AM,42097,Lehigh Valley,Central WDA,Northumberland,49,35 to 44 Years,Male,6333,639,3438,984,482,554,236,790,1272,40.8515093,-76.7118842
01/01/2011 12:00:00 AM,42097,Lehigh Valley,Central WDA,Northumberland,49,25 to 34 Years,Male,5626,683,2797,727,368,818,233,1051,1419,40.8515093,-76.7118842
01/01/2016 12:00:00 AM,42097,Lehigh Valley,Central WDA,Northumberland,49,25 to 34 Years,Male,6067,1065,2649,751,650,722,230,952,1602,40.8515093,-76.7118842
01/01/2013 12:00:00 AM,42097,Lehigh Valley,Central WDA,Northumberland,49,35 to 44 Years,Male,6263,658,3479,899,476,552,199,751,1227,40.8515093,-76.7118842
01/01/2010 12:00:00 AM,42097,Lehigh Valley,Central WDA,Northumberland,49,25 to 34 Years,Male,5477,868,2498,710,366,843,192,1035,1401,40.8515093,-76.7118842
01/01/2016 12:00:00 AM,42005,Southwest,Tri-County WDA,Armstrong,3,45 to 64 Years,Female,10319,870,4951,1796,1126,1056,520,1576,2702,40.8150953,-79.473169
01/01/2015 12:00:00 AM,42005,Southwest,Tri-County WDA,Armstrong,3,45 to 64 Years,Female,10331,906,5048,1755,1128,1043,451,1494,2622,40.8150953,-79.473169
01/01/2011 12:00:00 AM,42005,Southwest,Tri-County WDA,Armstrong,3,45 to 64 Years,Male,10682,730,5961,1568,862,1119,442,1561,2423,40.8150953,-79.473169
01/01/2012 12:00:00 AM,42005,Southwest,Tri-County WDA,Armstrong,3,45 to 64 Years,Male,10803,735,6052,1681,781,1120,434,1554,2335,40.8150953,-79.473169
01/01/2013 12:00:00 AM,42005,Southwest,Tri-County WDA,Armstrong,3,45 to 64 Years,Female,10448,744,5454,1805,998,1016,431,1447,2445,40.8150953,-79.473169
01/01/2014 12:00:00 AM,42005,Southwest,Tri-County WDA,Armstrong,3,45 to 64 Years,Female,10420,838,5202,1776,1171,1012,421,1433,2604,40.8150953,-79.473169
01/01/2010 12:00:00 AM,42005,Southwest,Tri-County WDA,Armstrong,3,45 to 64 Years,Male,10519,719,5872,1528,896,1085,419,1504,2400,40.8150953,-79.473169
01/01/2016 12:00:00 AM,42005,Southwest,Tri-County WDA,Armstrong,3,45 to 64 Years,Male,10591,863,5771,1691,881,987,398,1385,2266,40.8150953,-79.473169
01/01/2012 12:00:00 AM,42005,Southwest,Tri-County WDA,Armstrong,3,45 to 64 Years,Female,10448,1009,5396,1746,946,959,392,1351,2297,40.8150953,-79.473169
01/01/2010 12:00:00 AM,42005,Southwest,Tri-County WDA,Armstrong,3,45 to 64 Years,Female,10296,806,5723,1603,861,912,391,1303,2164,40.8150953,-79.473169
01/01/2015 12:00:00 AM,42005,Southwest,Tri-County WDA,Armstrong,3,45 to 64 Years,Male,10745,826,5962,1734,871,968,384,1352,2223,40.8150953,-79.473169
01/01/2013 12:00:00 AM,42005,Southwest,Tri-County WDA,Armstrong,3,45 to 64 Years,Male,10806,747,5984,1758,854,1092,371,1463,2317,40.8150953,-79.473169
01/01/2011 12:00:00 AM,42005,Southwest,Tri-County WDA,Armstrong,3,45 to 64 Years,Female,10417,936,5564,1720,903,937,357,1294,2197,40.8150953,-79.473169
01/01/2014 12:00:00 AM,42005,Southwest,Tri-County WDA,Armstrong,3,45 to 64 Years,Male,10813,751,6038,1750,862,1058,354,1412,2274,40.8150953,-79.473169
01/01/2015 12:00:00 AM,42005,Southwest,Tri-County WDA,Armstrong,3,25 to 34 Years,Female,3445,163,1018,715,574,652,323,975,1549,40.8150953,-79.473169
01/01/2016 12:00:00 AM,42005,Southwest,Tri-County WDA,Armstrong,3,25 to 34 Years,Female,3437,197,1007,695,549,669,320,989,1538,40.8150953,-79.473169
01/01/2012 12:00:00 AM,42005,Southwest,Tri-County WDA,Armstrong,3,25 to 34 Years,Female,3565,90,1174,714,587,684,316,1000,1587,40.8150953,-79.473169
01/01/2010 12:00:00 AM,42005,Southwest,Tri-County WDA,Armstrong,3,25 to 34 Years,Female,3603,149,1265,737,544,635,273,908,1452,40.8150953,-79.473169
01/01/2014 12:00:00 AM,42005,Southwest,Tri-County WDA,Armstrong,3,25 to 34 Years,Female,3512,136,1115,687,634,668,272,940,1574,40.8150953,-79.473169
01/01/2011 12:00:00 AM,42005,Southwest,Tri-County WDA,Armstrong,3,25 to 34 Years,Female,3588,149,1197,786,542,644,270,914,1456,40.8150953,-79.473169
01/01/2010 12:00:00 AM,42005,Southwest,Tri-County WDA,Armstrong,3,35 to 44 Years,Female,4560,166,2098,781,511,741,263,1004,1515,40.8150953,-79.473169
01/01/2013 12:00:00 AM,42005,Southwest,Tri-County WDA,Armstrong,3,25 to 34 Years,Female,3546,142,1076,736,600,736,256,992,1592,40.8150953,-79.473169
01/01/2016 12:00:00 AM,42005,Southwest,Tri-County WDA,Armstrong,3,35 to 44 Years,Male,3927,222,1732,683,552,505,233,738,1290,40.8150953,-79.473169
01/01/2016 12:00:00 AM,42005,Southwest,Tri-County WDA,Armstrong,3,35 to 44 Years,Female,3854,148,1405,821,595,686,199,885,1480,40.8150953,-79.473169
01/01/2011 12:00:00 AM,42005,Southwest,Tri-County WDA,Armstrong,3,35 to 44 Years,Female,4433,218,1982,824,484,732,193,925,1409,40.8150953,-79.473169
01/01/2015 12:00:00 AM,42005,Southwest,Tri-County WDA,Armstrong,3,35 to 44 Years,Male,4059,259,1754,803,526,528,189,717,1243,40.8150953,-79.473169
01/01/2014 12:00:00 AM,42005,Southwest,Tri-County WDA,Armstrong,3,35 to 44 Years,Female,4118,190,1535,879,581,750,183,933,1514,40.8150953,-79.473169
01/01/2012 12:00:00 AM,42005,Southwest,Tri-County WDA,Armstrong,3,35 to 44 Years,Female,4298,197,1768,833,588,737,175,912,1500,40.8150953,-79.473169
01/01/2010 12:00:00 AM,42005,Southwest,Tri-County WDA,Armstrong,3,35 to 44 Years,Male,4522,287,2450,617,413,591,164,755,1168,40.8150953,-79.473169
01/01/2013 12:00:00 AM,42005,Southwest,Tri-County WDA,Armstrong,3,35 to 44 Years,Female,4206,197,1603,865,642,744,155,899,1541,40.8150953,-79.473169
01/01/2015 12:00:00 AM,42005,Southwest,Tri-County WDA,Armstrong,3,35 to 44 Years,Female,3997,176,1578,833,554,703,153,856,1410,40.8150953,-79.473169
01/01/2011 12:00:00 AM,42005,Southwest,Tri-County WDA,Armstrong,3,35 to 44 Years,Male,4443,245,2329,728,481,511,149,660,1141,40.8150953,-79.473169
01/01/2012 12:00:00 AM,42005,Southwest,Tri-County WDA,Armstrong,3,35 to 44 Years,Male,4310,353,2176,663,439,541,138,679,1118,40.8150953,-79.473169
01/01/2014 12:00:00 AM,42005,Southwest,Tri-County WDA,Armstrong,3,35 to 44 Years,Male,4139,303,1893,805,525,481,132,613,1138,40.8150953,-79.473169
01/01/2013 12:00:00 AM,42005,Southwest,Tri-County WDA,Armstrong,3,35 to 44 Years,Male,4214,323,2079,681,486,524,121,645,1131,40.8150953,-79.473169
01/01/2015 12:00:00 AM,42005,Southwest,Tri-County WDA,Armstrong,3,25 to 34 Years,Male,3614,336,1617,572,434,539,116,655,1089,40.8150953,-79.473169
01/01/2014 12:00:00 AM,42005,Southwest,Tri-County WDA,Armstrong,3,25 to 34 Years,Male,3621,303,1642,612,386,563,115,678,1064,40.8150953,-79.473169
01/01/2016 12:00:00 AM,42005,Southwest,Tri-County WDA,Armstrong,3,25 to 34 Years,Male,3683,327,1638,552,486,569,111,680,1166,40.8150953,-79.473169
01/01/2013 12:00:00 AM,42005,Southwest,Tri-County WDA,Armstrong,3,25 to 34 Years,Male,3688,280,1735,673,391,516,93,609,1000,40.8150953,-79.473169
01/01/2010 12:00:00 AM,42005,Southwest,Tri-County WDA,Armstrong,3,25 to 34 Years,Male,3730,248,1753,852,313,471,93,564,877,40.8150953,-79.473169
01/01/2012 12:00:00 AM,42005,Southwest,Tri-County WDA,Armstrong,3,25 to 34 Years,Male,3698,275,1757,718,377,482,89,571,948,40.8150953,-79.473169
01/01/2011 12:00:00 AM,42005,Southwest,Tri-County WDA,Armstrong,3,25 to 34 Years,Male,3704,351,1695,845,287,451,75,526,813,40.8150953,-79.473169
01/01/2014 12:00:00 AM,42109,Lehigh Valley,Central WDA,Snyder,55,45 to 64 Years,Female,5407,698,2639,795,452,420,403,823,1275,40.7711374,-77.0725597
01/01/2013 12:00:00 AM,42109,Lehigh Valley,Central WDA,Snyder,55,45 to 64 Years,Female,5369,659,2661,762,398,488,401,889,1287,40.7711374,-77.0725597
01/01/2015 12:00:00 AM,42109,Lehigh Valley,Central WDA,Snyder,55,45 to 64 Years,Female,5413,739,2594,724,532,423,401,824,1356,40.7711374,-77.0725597
01/01/2012 12:00:00 AM,42109,Lehigh Valley,Central WDA,Snyder,55,45 to 64 Years,Female,5333,649,2795,681,377,460,371,831,1208,40.7711374,-77.0725597
01/01/2011 12:00:00 AM,42109,Lehigh Valley,Central WDA,Snyder,55,45 to 64 Years,Female,5296,686,2728,621,406,493,362,855,1261,40.7711374,-77.0725597
01/01/2011 12:00:00 AM,42109,Lehigh Valley,Central WDA,Snyder,55,45 to 64 Years,Male,5229,793,2527,637,345,566,361,927,1272,40.7711374,-77.0725597
01/01/2013 12:00:00 AM,42109,Lehigh Valley,Central WDA,Snyder,55,45 to 64 Years,Male,5355,741,2510,631,520,610,343,953,1473,40.7711374,-77.0725597
01/01/2010 12:00:00 AM,42109,Lehigh Valley,Central WDA,Snyder,55,45 to 64 Years,Female,5231,671,2681,674,367,505,333,838,1205,40.7711374,-77.0725597
01/01/2016 12:00:00 AM,42109,Lehigh Valley,Central WDA,Snyder,55,45 to 64 Years,Female,5396,684,2633,697,582,469,331,800,1382,40.7711374,-77.0725597
01/01/2012 12:00:00 AM,42109,Lehigh Valley,Central WDA,Snyder,55,45 to 64 Years,Male,5278,670,2577,657,453,594,327,921,1374,40.7711374,-77.0725597
01/01/2010 12:00:00 AM,42109,Lehigh Valley,Central WDA,Snyder,55,45 to 64 Years,Male,5205,1018,2387,641,341,506,312,818,1159,40.7711374,-77.0725597
01/01/2014 12:00:00 AM,42109,Lehigh Valley,Central WDA,Snyder,55,45 to 64 Years,Male,5399,746,2719,581,496,569,288,857,1353,40.7711374,-77.0725597
01/01/2015 12:00:00 AM,42109,Lehigh Valley,Central WDA,Snyder,55,45 to 64 Years,Male,5404,770,2796,523,460,582,273,855,1315,40.7711374,-77.0725597
01/01/2016 12:00:00 AM,42109,Lehigh Valley,Central WDA,Snyder,55,35 to 44 Years,Female,2297,300,764,394,338,266,235,501,839,40.7711374,-77.0725597
01/01/2015 12:00:00 AM,42109,Lehigh Valley,Central WDA,Snyder,55,25 to 34 Years,Female,2151,290,726,343,179,392,221,613,792,40.7711374,-77.0725597
01/01/2014 12:00:00 AM,42109,Lehigh Valley,Central WDA,Snyder,55,25 to 34 Years,Female,2106,292,691,247,253,413,210,623,876,40.7711374,-77.0725597
01/01/2016 12:00:00 AM,42109,Lehigh Valley,Central WDA,Snyder,55,45 to 64 Years,Male,5440,745,2767,658,396,667,207,874,1270,40.7711374,-77.0725597
01/01/2010 12:00:00 AM,42109,Lehigh Valley,Central WDA,Snyder,55,35 to 44 Years,Female,2506,205,1314,284,259,239,205,444,703,40.7711374,-77.0725597
01/01/2011 12:00:00 AM,42109,Lehigh Valley,Central WDA,Snyder,55,35 to 44 Years,Female,2476,242,1281,283,274,193,203,396,670,40.7711374,-77.0725597
01/01/2014 12:00:00 AM,42109,Lehigh Valley,Central WDA,Snyder,55,35 to 44 Years,Female,2385,328,978,400,257,228,194,422,679,40.7711374,-77.0725597
01/01/2013 12:00:00 AM,42109,Lehigh Valley,Central WDA,Snyder,55,25 to 34 Years,Female,2069,232,699,276,283,387,192,579,862,40.7711374,-77.0725597
01/01/2012 12:00:00 AM,42109,Lehigh Valley,Central WDA,Snyder,55,35 to 44 Years,Female,2440,257,1171,370,261,192,189,381,642,40.7711374,-77.0725597
01/01/2013 12:00:00 AM,42109,Lehigh Valley,Central WDA,Snyder,55,35 to 44 Years,Female,2387,307,1074,385,226,207,188,395,621,40.7711374,-77.0725597
01/01/2012 12:00:00 AM,42109,Lehigh Valley,Central WDA,Snyder,55,25 to 34 Years,Female,2050,247,616,303,340,365,179,544,884,40.7711374,-77.0725597
01/01/2016 12:00:00 AM,42109,Lehigh Valley,Central WDA,Snyder,55,25 to 34 Years,Female,2177,326,733,339,229,373,177,550,779,40.7711374,-77.0725597
01/01/2015 12:00:00 AM,42109,Lehigh Valley,Central WDA,Snyder,55,35 to 44 Years,Female,2370,296,935,398,319,253,169,422,741,40.7711374,-77.0725597
01/01/2011 12:00:00 AM,42109,Lehigh Valley,Central WDA,Snyder,55,25 to 34 Years,Female,2036,227,631,294,355,378,151,529,884,40.7711374,-77.0725597
01/01/2014 12:00:00 AM,42109,Lehigh Valley,Central WDA,Snyder,55,35 to 44 Years,Male,2373,429,978,280,200,340,146,486,686,40.7711374,-77.0725597
01/01/2015 12:00:00 AM,42109,Lehigh Valley,Central WDA,Snyder,55,35 to 44 Years,Male,2311,397,992,302,183,291,146,437,620,40.7711374,-77.0725597
01/01/2013 12:00:00 AM,42109,Lehigh Valley,Central WDA,Snyder,55,35 to 44 Years,Male,2393,355,1069,322,205,301,141,442,647,40.7711374,-77.0725597
01/01/2012 12:00:00 AM,42109,Lehigh Valley,Central WDA,Snyder,55,35 to 44 Years,Male,2455,343,1114,303,262,301,132,433,695,40.7711374,-77.0725597
01/01/2016 12:00:00 AM,42109,Lehigh Valley,Central WDA,Snyder,55,35 to 44 Years,Male,2286,369,1077,284,192,233,131,364,556,40.7711374,-77.0725597
01/01/2010 12:00:00 AM,42109,Lehigh Valley,Central WDA,Snyder,55,35 to 44 Years,Male,2600,380,1228,292,280,307,113,420,700,40.7711374,-77.0725597
01/01/2011 12:00:00 AM,42109,Lehigh Valley,Central WDA,Snyder,55,35 to 44 Years,Male,2507,345,1108,306,301,340,107,447,748,40.7711374,-77.0725597
01/01/2010 12:00:00 AM,42109,Lehigh Valley,Central WDA,Snyder,55,25 to 34 Years,Female,2058,184,684,328,405,362,95,457,862,40.7711374,-77.0725597
01/01/2010 12:00:00 AM,42109,Lehigh Valley,Central WDA,Snyder,55,25 to 34 Years,Male,2006,278,801,281,188,375,83,458,646,40.7711374,-77.0725597
01/01/2011 12:00:00 AM,42109,Lehigh Valley,Central WDA,Snyder,55,25 to 34 Years,Male,2063,276,813,292,221,388,73,461,682,40.7711374,-77.0725597
01/01/2012 12:00:00 AM,42109,Lehigh Valley,Central WDA,Snyder,55,25 to 34 Years,Male,2066,325,820,256,280,317,68,385,665,40.7711374,-77.0725597
01/01/2014 12:00:00 AM,42109,Lehigh Valley,Central WDA,Snyder,55,25 to 34 Years,Male,2222,363,948,249,261,338,63,401,662,40.7711374,-77.0725597
01/01/2013 12:00:00 AM,42109,Lehigh Valley,Central WDA,Snyder,55,25 to 34 Years,Male,2131,318,897,236,297,326,57,383,680,40.7711374,-77.0725597
01/01/2015 12:00:00 AM,42109,Lehigh Valley,Central WDA,Snyder,55,25 to 34 Years,Male,2250,423,966,271,244,296,50,346,590,40.7711374,-77.0725597
01/01/2016 12:00:00 AM,42109,Lehigh Valley,Central WDA,Snyder,55,25 to 34 Years,Male,2245,446,886,253,266,351,43,394,660,40.7711374,-77.0725597
01/01/2012 12:00:00 AM,42095,Lehigh Valley,Lehigh Valley WDA,Northampton,48,45 to 64 Years,Male,41459,3735,15273,7847,3022,7088,4494,11582,14604,40.7545954,-75.3126373
01/01/2013 12:00:00 AM,42095,Lehigh Valley,Lehigh Valley WDA,Northampton,48,45 to 64 Years,Male,41909,3421,16026,8047,3294,6668,4453,11121,14415,40.7545954,-75.3126373
01/01/2016 12:00:00 AM,42095,Lehigh Valley,Lehigh Valley WDA,Northampton,48,45 to 64 Years,Female,43847,2666,14931,8827,5357,7617,4449,12066,17423,40.7545954,-75.3126373
01/01/2014 12:00:00 AM,42095,Lehigh Valley,Lehigh Valley WDA,Northampton,48,45 to 64 Years,Male,42131,3500,16048,8193,3143,6838,4409,11247,14390,40.7545954,-75.3126373
01/01/2011 12:00:00 AM,42095,Lehigh Valley,Lehigh Valley WDA,Northampton,48,45 to 64 Years,Male,40945,3919,14985,7536,2942,7163,4400,11563,14505,40.7545954,-75.3126373
01/01/2015 12:00:00 AM,42095,Lehigh Valley,Lehigh Valley WDA,Northampton,48,45 to 64 Years,Female,43870,2677,15790,8851,5181,6983,4388,11371,16552,40.7545954,-75.3126373
01/01/2010 12:00:00 AM,42095,Lehigh Valley,Lehigh Valley WDA,Northampton,48,45 to 64 Years,Male,40114,3740,14864,6877,3029,7289,4315,11604,14633,40.7545954,-75.3126373
01/01/2015 12:00:00 AM,42095,Lehigh Valley,Lehigh Valley WDA,Northampton,48,45 to 64 Years,Male,42139,3493,15885,8480,3230,6841,4210,11051,14281,40.7545954,-75.3126373
01/01/2013 12:00:00 AM,42095,Lehigh Valley,Lehigh Valley WDA,Northampton,48,45 to 64 Years,Female,43663,3419,16286,8145,5157,6613,4043,10656,15813,40.7545954,-75.3126373
01/01/2014 12:00:00 AM,42095,Lehigh Valley,Lehigh Valley WDA,Northampton,48,45 to 64 Years,Female,43836,3025,16106,8589,5254,6847,4015,10862,16116,40.7545954,-75.3126373
01/01/2016 12:00:00 AM,42095,Lehigh Valley,Lehigh Valley WDA,Northampton,48,45 to 64 Years,Male,41989,3239,15864,8445,3405,7038,3998,11036,14441,40.7545954,-75.3126373
01/01/2012 12:00:00 AM,42095,Lehigh Valley,Lehigh Valley WDA,Northampton,48,45 to 64 Years,Female,43258,3626,16351,7823,4730,6747,3981,10728,15458,40.7545954,-75.3126373
01/01/2011 12:00:00 AM,42095,Lehigh Valley,Lehigh Valley WDA,Northampton,48,45 to 64 Years,Female,42644,3804,16688,7160,4612,6469,3911,10380,14992,40.7545954,-75.3126373
01/01/2010 12:00:00 AM,42095,Lehigh Valley,Lehigh Valley WDA,Northampton,48,45 to 64 Years,Female,41817,3943,16419,7161,4344,6130,3820,9950,14294,40.7545954,-75.3126373
01/01/2011 12:00:00 AM,42095,Lehigh Valley,Lehigh Valley WDA,Northampton,48,35 to 44 Years,Female,20398,1012,5456,4418,2367,4513,2632,7145,9512,40.7545954,-75.3126373
01/01/2014 12:00:00 AM,42095,Lehigh Valley,Lehigh Valley WDA,Northampton,48,35 to 44 Years,Female,18954,904,5062,4036,2147,4182,2623,6805,8952,40.7545954,-75.3126373
01/01/2012 12:00:00 AM,42095,Lehigh Valley,Lehigh Valley WDA,Northampton,48,35 to 44 Years,Female,19914,860,5405,4311,2243,4507,2588,7095,9338,40.7545954,-75.3126373
01/01/2016 12:00:00 AM,42095,Lehigh Valley,Lehigh Valley WDA,Northampton,48,35 to 44 Years,Female,18333,929,4777,3480,2167,4392,2588,6980,9147,40.7545954,-75.3126373
01/01/2013 12:00:00 AM,42095,Lehigh Valley,Lehigh Valley WDA,Northampton,48,35 to 44 Years,Female,19356,916,5281,4139,2202,4250,2568,6818,9020,40.7545954,-75.3126373
01/01/2015 12:00:00 AM,42095,Lehigh Valley,Lehigh Valley WDA,Northampton,48,35 to 44 Years,Female,18648,1058,4880,3604,2256,4337,2513,6850,9106,40.7545954,-75.3126373
01/01/2010 12:00:00 AM,42095,Lehigh Valley,Lehigh Valley WDA,Northampton,48,35 to 44 Years,Female,20796,1055,5614,4742,2391,4536,2458,6994,9385,40.7545954,-75.3126373
01/01/2014 12:00:00 AM,42095,Lehigh Valley,Lehigh Valley WDA,Northampton,48,25 to 34 Years,Female,16605,999,3524,3684,1504,4448,2446,6894,8398,40.7545954,-75.3126373
01/01/2013 12:00:00 AM,42095,Lehigh Valley,Lehigh Valley WDA,Northampton,48,25 to 34 Years,Female,16441,1125,3424,3435,1606,4443,2408,6851,8457,40.7545954,-75.3126373
01/01/2011 12:00:00 AM,42095,Lehigh Valley,Lehigh Valley WDA,Northampton,48,25 to 34 Years,Female,16169,1175,3607,2956,1637,4412,2382,6794,8431,40.7545954,-75.3126373
01/01/2015 12:00:00 AM,42095,Lehigh Valley,Lehigh Valley WDA,Northampton,48,25 to 34 Years,Female,16838,814,3703,3825,1826,4304,2366,6670,8496,40.7545954,-75.3126373
01/01/2012 12:00:00 AM,42095,Lehigh Valley,Lehigh Valley WDA,Northampton,48,25 to 34 Years,Female,16255,1109,3574,3379,1584,4247,2362,6609,8193,40.7545954,-75.3126373
01/01/2016 12:00:00 AM,42095,Lehigh Valley,Lehigh Valley WDA,Northampton,48,25 to 34 Years,Female,16939,618,3793,3858,1895,4454,2321,6775,8670,40.7545954,-75.3126373
01/01/2010 12:00:00 AM,42095,Lehigh Valley,Lehigh Valley WDA,Northampton,48,35 to 44 Years,Male,20376,1627,7169,3848,1705,3863,2164,6027,7732,40.7545954,-75.3126373
01/01/2010 12:00:00 AM,42095,Lehigh Valley,Lehigh Valley WDA,Northampton,48,25 to 34 Years,Female,16073,1191,3561,2983,1782,4411,2145,6556,8338,40.7545954,-75.3126373
01/01/2011 12:00:00 AM,42095,Lehigh Valley,Lehigh Valley WDA,Northampton,48,35 to 44 Years,Male,19913,1650,6578,3927,1690,4023,2045,6068,7758,40.7545954,-75.3126373
01/01/2012 12:00:00 AM,42095,Lehigh Valley,Lehigh Valley WDA,Northampton,48,35 to 44 Years,Male,19409,1580,6340,4042,1668,3907,1872,5779,7447,40.7545954,-75.3126373
01/01/2013 12:00:00 AM,42095,Lehigh Valley,Lehigh Valley WDA,Northampton,48,35 to 44 Years,Male,18785,1584,6270,3682,1687,3722,1840,5562,7249,40.7545954,-75.3126373
01/01/2014 12:00:00 AM,42095,Lehigh Valley,Lehigh Valley WDA,Northampton,48,35 to 44 Years,Male,18341,1728,5862,3521,1527,3877,1826,5703,7230,40.7545954,-75.3126373
01/01/2016 12:00:00 AM,42095,Lehigh Valley,Lehigh Valley WDA,Northampton,48,35 to 44 Years,Male,17658,1458,5864,3109,1576,3891,1760,5651,7227,40.7545954,-75.3126373
01/01/2015 12:00:00 AM,42095,Lehigh Valley,Lehigh Valley WDA,Northampton,48,35 to 44 Years,Male,17973,1793,5698,3211,1706,3809,1756,5565,7271,40.7545954,-75.3126373
01/01/2014 12:00:00 AM,42095,Lehigh Valley,Lehigh Valley WDA,Northampton,48,25 to 34 Years,Male,16592,1123,4740,3701,1632,3812,1584,5396,7028,40.7545954,-75.3126373
01/01/2011 12:00:00 AM,42095,Lehigh Valley,Lehigh Valley WDA,Northampton,48,25 to 34 Years,Male,15944,1494,4652,3072,1623,3570,1533,5103,6726,40.7545954,-75.3126373
01/01/2016 12:00:00 AM,42095,Lehigh Valley,Lehigh Valley WDA,Northampton,48,25 to 34 Years,Male,17451,1098,4996,3911,1979,3975,1492,5467,7446,40.7545954,-75.3126373
01/01/2012 12:00:00 AM,42095,Lehigh Valley,Lehigh Valley WDA,Northampton,48,25 to 34 Years,Male,16076,1296,4679,3391,1627,3593,1490,5083,6710,40.7545954,-75.3126373
01/01/2013 12:00:00 AM,42095,Lehigh Valley,Lehigh Valley WDA,Northampton,48,25 to 34 Years,Male,16330,1321,4515,3578,1688,3780,1448,5228,6916,40.7545954,-75.3126373
01/01/2015 12:00:00 AM,42095,Lehigh Valley,Lehigh Valley WDA,Northampton,48,25 to 34 Years,Male,16920,934,4912,3914,1672,4069,1419,5488,7160,40.7545954,-75.3126373
01/01/2010 12:00:00 AM,42095,Lehigh Valley,Lehigh Valley WDA,Northampton,48,25 to 34 Years,Male,15919,1832,4656,3123,1460,3435,1413,4848,6308,40.7545954,-75.3126373
01/01/2010 12:00:00 AM,42107,Northeast,Luzerne-Schuylkill Counties WDA,Schuylkill,54,45 to 64 Years,Female,20611,2271,10350,2815,1925,1780,1470,3250,5175,40.7075124,-76.2233239
01/01/2016 12:00:00 AM,42107,Northeast,Luzerne-Schuylkill Counties WDA,Schuylkill,54,45 to 64 Years,Female,20736,1847,9954,3178,2441,1952,1364,3316,5757,40.7075124,-76.2233239
01/01/2011 12:00:00 AM,42107,Northeast,Luzerne-Schuylkill Counties WDA,Schuylkill,54,45 to 64 Years,Female,20786,2281,10457,2889,1993,1810,1356,3166,5159,40.7075124,-76.2233239
01/01/2014 12:00:00 AM,42107,Northeast,Luzerne-Schuylkill Counties WDA,Schuylkill,54,45 to 64 Years,Female,20937,1931,10435,3026,2269,1966,1310,3276,5545,40.7075124,-76.2233239
01/01/2012 12:00:00 AM,42107,Northeast,Luzerne-Schuylkill Counties WDA,Schuylkill,54,45 to 64 Years,Female,20948,2064,10517,3140,2019,1914,1294,3208,5227,40.7075124,-76.2233239
01/01/2011 12:00:00 AM,42107,Northeast,Luzerne-Schuylkill Counties WDA,Schuylkill,54,45 to 64 Years,Male,22034,2676,11155,3107,1767,2049,1280,3329,5096,40.7075124,-76.2233239
01/01/2013 12:00:00 AM,42107,Northeast,Luzerne-Schuylkill Counties WDA,Schuylkill,54,45 to 64 Years,Female,20997,2007,10604,3114,2094,1916,1262,3178,5272,40.7075124,-76.2233239
01/01/2015 12:00:00 AM,42107,Northeast,Luzerne-Schuylkill Counties WDA,Schuylkill,54,45 to 64 Years,Female,20832,1849,10348,3035,2354,1999,1247,3246,5600,40.7075124,-76.2233239
01/01/2010 12:00:00 AM,42107,Northeast,Luzerne-Schuylkill Counties WDA,Schuylkill,54,45 to 64 Years,Male,21537,2788,11161,2859,1583,1954,1192,3146,4729,40.7075124,-76.2233239
01/01/2015 12:00:00 AM,42107,Northeast,Luzerne-Schuylkill Counties WDA,Schuylkill,54,45 to 64 Years,Male,22210,2321,11299,3644,1986,1819,1141,2960,4946,40.7075124,-76.2233239
01/01/2016 12:00:00 AM,42107,Northeast,Luzerne-Schuylkill Counties WDA,Schuylkill,54,45 to 64 Years,Male,21993,2307,11454,3488,1848,1786,1110,2896,4744,40.7075124,-76.2233239
01/01/2012 12:00:00 AM,42107,Northeast,Luzerne-Schuylkill Counties WDA,Schuylkill,54,45 to 64 Years,Male,22116,2492,11350,3320,1880,1966,1108,3074,4954,40.7075124,-76.2233239
01/01/2014 12:00:00 AM,42107,Northeast,Luzerne-Schuylkill Counties WDA,Schuylkill,54,45 to 64 Years,Male,22366,2285,11321,3751,1984,1931,1094,3025,5009,40.7075124,-76.2233239
01/01/2013 12:00:00 AM,42107,Northeast,Luzerne-Schuylkill Counties WDA,Schuylkill,54,45 to 64 Years,Male,22241,2409,11385,3483,2005,1889,1070,2959,4964,40.7075124,-76.2233239
01/01/2016 12:00:00 AM,42107,Northeast,Luzerne-Schuylkill Counties WDA,Schuylkill,54,35 to 44 Years,Female,8446,476,2731,1680,1523,1147,889,2036,3559,40.7075124,-76.2233239
01/01/2015 12:00:00 AM,42107,Northeast,Luzerne-Schuylkill Counties WDA,Schuylkill,54,35 to 44 Years,Female,8711,554,2948,1560,1602,1204,843,2047,3649,40.7075124,-76.2233239
01/01/2013 12:00:00 AM,42107,Northeast,Luzerne-Schuylkill Counties WDA,Schuylkill,54,35 to 44 Years,Female,9122,726,3354,1505,1481,1222,834,2056,3537,40.7075124,-76.2233239
01/01/2011 12:00:00 AM,42107,Northeast,Luzerne-Schuylkill Counties WDA,Schuylkill,54,35 to 44 Years,Female,9489,814,3656,1530,1417,1303,769,2072,3489,40.7075124,-76.2233239
01/01/2010 12:00:00 AM,42107,Northeast,Luzerne-Schuylkill Counties WDA,Schuylkill,54,35 to 44 Years,Female,9699,794,3957,1632,1310,1242,764,2006,3316,40.7075124,-76.2233239
01/01/2012 12:00:00 AM,42107,Northeast,Luzerne-Schuylkill Counties WDA,Schuylkill,54,35 to 44 Years,Female,9398,752,3525,1625,1443,1297,756,2053,3496,40.7075124,-76.2233239
01/01/2014 12:00:00 AM,42107,Northeast,Luzerne-Schuylkill Counties WDA,Schuylkill,54,35 to 44 Years,Female,8933,649,3190,1610,1474,1264,746,2010,3484,40.7075124,-76.2233239
01/01/2015 12:00:00 AM,42107,Northeast,Luzerne-Schuylkill Counties WDA,Schuylkill,54,35 to 44 Years,Male,10248,1150,4732,1907,952,842,665,1507,2459,40.7075124,-76.2233239
01/01/2011 12:00:00 AM,42107,Northeast,Luzerne-Schuylkill Counties WDA,Schuylkill,54,35 to 44 Years,Male,11209,1325,5494,1963,850,940,637,1577,2427,40.7075124,-76.2233239
01/01/2016 12:00:00 AM,42107,Northeast,Luzerne-Schuylkill Counties WDA,Schuylkill,54,25 to 34 Years,Female,7557,575,2002,1393,1425,1558,604,2162,3587,40.7075124,-76.2233239
01/01/2012 12:00:00 AM,42107,Northeast,Luzerne-Schuylkill Counties WDA,Schuylkill,54,35 to 44 Years,Male,11032,1304,5320,2097,796,911,604,1515,2311,40.7075124,-76.2233239
01/01/2015 12:00:00 AM,42107,Northeast,Luzerne-Schuylkill Counties WDA,Schuylkill,54,25 to 34 Years,Female,7712,640,2118,1426,1318,1609,601,2210,3528,40.7075124,-76.2233239
01/01/2013 12:00:00 AM,42107,Northeast,Luzerne-Schuylkill Counties WDA,Schuylkill,54,35 to 44 Years,Male,10719,1314,5059,1943,890,914,599,1513,2403,40.7075124,-76.2233239
01/01/2014 12:00:00 AM,42107,Northeast,Luzerne-Schuylkill Counties WDA,Schuylkill,54,25 to 34 Years,Female,7716,549,2217,1506,1326,1529,589,2118,3444,40.7075124,-76.2233239
01/01/2014 12:00:00 AM,42107,Northeast,Luzerne-Schuylkill Counties WDA,Schuylkill,54,35 to 44 Years,Male,10682,1258,5036,1994,869,945,580,1525,2394,40.7075124,-76.2233239
01/01/2011 12:00:00 AM,42107,Northeast,Luzerne-Schuylkill Counties WDA,Schuylkill,54,25 to 34 Years,Female,7549,554,2452,1458,1284,1235,566,1801,3085,40.7075124,-76.2233239
01/01/2016 12:00:00 AM,42107,Northeast,Luzerne-Schuylkill Counties WDA,Schuylkill,54,35 to 44 Years,Male,10058,1256,4582,1915,894,860,551,1411,2305,40.7075124,-76.2233239
01/01/2013 12:00:00 AM,42107,Northeast,Luzerne-Schuylkill Counties WDA,Schuylkill,54,25 to 34 Years,Female,7649,564,2343,1506,1372,1360,504,1864,3236,40.7075124,-76.2233239
01/01/2010 12:00:00 AM,42107,Northeast,Luzerne-Schuylkill Counties WDA,Schuylkill,54,25 to 34 Years,Female,7559,591,2612,1439,1330,1084,503,1587,2917,40.7075124,-76.2233239
01/01/2012 12:00:00 AM,42107,Northeast,Luzerne-Schuylkill Counties WDA,Schuylkill,54,25 to 34 Years,Female,7529,550,2500,1488,1261,1237,493,1730,2991,40.7075124,-76.2233239
01/01/2010 12:00:00 AM,42107,Northeast,Luzerne-Schuylkill Counties WDA,Schuylkill,54,35 to 44 Years,Male,11455,1789,5446,1909,824,1012,475,1487,2311,40.7075124,-76.2233239
01/01/2016 12:00:00 AM,42107,Northeast,Luzerne-Schuylkill Counties WDA,Schuylkill,54,25 to 34 Years,Male,9378,1103,4232,1533,883,1291,336,1627,2510,40.7075124,-76.2233239
01/01/2012 12:00:00 AM,42107,Northeast,Luzerne-Schuylkill Counties WDA,Schuylkill,54,25 to 34 Years,Male,9489,1373,4496,1524,727,1039,330,1369,2096,40.7075124,-76.2233239
01/01/2011 12:00:00 AM,42107,Northeast,Luzerne-Schuylkill Counties WDA,Schuylkill,54,25 to 34 Years,Male,9507,1470,4361,1548,785,1021,322,1343,2128,40.7075124,-76.2233239
01/01/2010 12:00:00 AM,42107,Northeast,Luzerne-Schuylkill Counties WDA,Schuylkill,54,25 to 34 Years,Male,9498,1598,4286,1526,869,900,319,1219,2088,40.7075124,-76.2233239
01/01/2013 12:00:00 AM,42107,Northeast,Luzerne-Schuylkill Counties WDA,Schuylkill,54,25 to 34 Years,Male,9430,1321,4387,1495,794,1139,294,1433,2227,40.7075124,-76.2233239
01/01/2015 12:00:00 AM,42107,Northeast,Luzerne-Schuylkill Counties WDA,Schuylkill,54,25 to 34 Years,Male,9357,1137,4216,1565,818,1337,284,1621,2439,40.7075124,-76.2233239
01/01/2014 12:00:00 AM,42107,Northeast,Luzerne-Schuylkill Counties WDA,Schuylkill,54,25 to 34 Years,Male,9364,1267,4329,1424,782,1280,282,1562,2344,40.7075124,-76.2233239
01/01/2013 12:00:00 AM,42007,Southwest,Southwest Corner WDA,Beaver,4,45 to 64 Years,Female,26847,1526,10892,4934,3624,3795,2076,5871,9495,40.6834925,-80.3510736
01/01/2014 12:00:00 AM,42007,Southwest,Southwest Corner WDA,Beaver,4,45 to 64 Years,Female,26780,1542,10845,4727,3693,3959,2014,5973,9666,40.6834925,-80.3510736
01/01/2012 12:00:00 AM,42007,Southwest,Southwest Corner WDA,Beaver,4,45 to 64 Years,Male,25279,1727,10503,4924,2586,3557,1982,5539,8125,40.6834925,-80.3510736
01/01/2013 12:00:00 AM,42007,Southwest,Southwest Corner WDA,Beaver,4,45 to 64 Years,Male,25292,1626,10354,4883,2591,3857,1981,5838,8429,40.6834925,-80.3510736
01/01/2011 12:00:00 AM,42007,Southwest,Southwest Corner WDA,Beaver,4,45 to 64 Years,Female,26623,1739,11057,5112,3246,3490,1979,5469,8715,40.6834925,-80.3510736
01/01/2014 12:00:00 AM,42007,Southwest,Southwest Corner WDA,Beaver,4,45 to 64 Years,Male,25272,1591,10220,4784,2771,3928,1978,5906,8677,40.6834925,-80.3510736
01/01/2015 12:00:00 AM,42007,Southwest,Southwest Corner WDA,Beaver,4,45 to 64 Years,Male,25121,1523,9682,4951,3095,3922,1948,5870,8965,40.6834925,-80.3510736
01/01/2011 12:00:00 AM,42007,Southwest,Southwest Corner WDA,Beaver,4,45 to 64 Years,Male,25151,1711,10764,5038,2317,3405,1916,5321,7638,40.6834925,-80.3510736
01/01/2012 12:00:00 AM,42007,Southwest,Southwest Corner WDA,Beaver,4,45 to 64 Years,Female,26788,1585,11162,4998,3494,3669,1880,5549,9043,40.6834925,-80.3510736
01/01/2015 12:00:00 AM,42007,Southwest,Southwest Corner WDA,Beaver,4,45 to 64 Years,Female,26544,1348,10770,4903,3738,3975,1810,5785,9523,40.6834925,-80.3510736
01/01/2010 12:00:00 AM,42007,Southwest,Southwest Corner WDA,Beaver,4,45 to 64 Years,Male,24870,1805,11041,4756,2233,3240,1795,5035,7268,40.6834925,-80.3510736
01/01/2016 12:00:00 AM,42007,Southwest,Southwest Corner WDA,Beaver,4,45 to 64 Years,Male,24763,1478,9800,4720,3075,3940,1750,5690,8765,40.6834925,-80.3510736
01/01/2010 12:00:00 AM,42007,Southwest,Southwest Corner WDA,Beaver,4,45 to 64 Years,Female,26328,1802,11272,5011,3088,3407,1748,5155,8243,40.6834925,-80.3510736
01/01/2016 12:00:00 AM,42007,Southwest,Southwest Corner WDA,Beaver,4,45 to 64 Years,Female,26225,1121,10640,4869,3831,4037,1727,5764,9595,40.6834925,-80.3510736
01/01/2016 12:00:00 AM,42007,Southwest,Southwest Corner WDA,Beaver,4,35 to 44 Years,Female,9614,367,2417,1733,1862,2016,1219,3235,5097,40.6834925,-80.3510736
01/01/2015 12:00:00 AM,42007,Southwest,Southwest Corner WDA,Beaver,4,35 to 44 Years,Female,9697,296,2596,1917,1824,1957,1107,3064,4888,40.6834925,-80.3510736
01/01/2014 12:00:00 AM,42007,Southwest,Southwest Corner WDA,Beaver,4,35 to 44 Years,Female,9802,329,2846,1889,1829,1812,1097,2909,4738,40.6834925,-80.3510736
01/01/2016 12:00:00 AM,42007,Southwest,Southwest Corner WDA,Beaver,4,25 to 34 Years,Female,9583,536,2099,2048,1346,2536,1018,3554,4900,40.6834925,-80.3510736
01/01/2013 12:00:00 AM,42007,Southwest,Southwest Corner WDA,Beaver,4,35 to 44 Years,Female,10040,363,3011,2019,1959,1672,1016,2688,4647,40.6834925,-80.3510736
01/01/2015 12:00:00 AM,42007,Southwest,Southwest Corner WDA,Beaver,4,25 to 34 Years,Female,9529,449,2069,2239,1384,2381,1007,3388,4772,40.6834925,-80.3510736
01/01/2012 12:00:00 AM,42007,Southwest,Southwest Corner WDA,Beaver,4,35 to 44 Years,Female,10390,386,3232,2222,1961,1645,944,2589,4550,40.6834925,-80.3510736
01/01/2011 12:00:00 AM,42007,Southwest,Southwest Corner WDA,Beaver,4,35 to 44 Years,Female,10720,397,3469,2303,1815,1815,921,2736,4551,40.6834925,-80.3510736
01/01/2013 12:00:00 AM,42007,Southwest,Southwest Corner WDA,Beaver,4,25 to 34 Years,Female,9219,417,2080,2150,1478,2209,885,3094,4572,40.6834925,-80.3510736
01/01/2014 12:00:00 AM,42007,Southwest,Southwest Corner WDA,Beaver,4,25 to 34 Years,Female,9389,423,1936,2333,1440,2390,867,3257,4697,40.6834925,-80.3510736
01/01/2012 12:00:00 AM,42007,Southwest,Southwest Corner WDA,Beaver,4,25 to 34 Years,Female,9087,494,1929,2168,1497,2151,848,2999,4496,40.6834925,-80.3510736
01/01/2011 12:00:00 AM,42007,Southwest,Southwest Corner WDA,Beaver,4,25 to 34 Years,Female,9021,491,2163,2143,1429,1989,806,2795,4224,40.6834925,-80.3510736
01/01/2010 12:00:00 AM,42007,Southwest,Southwest Corner WDA,Beaver,4,35 to 44 Years,Female,11178,345,4004,2335,1867,1833,794,2627,4494,40.6834925,-80.3510736
01/01/2010 12:00:00 AM,42007,Southwest,Southwest Corner WDA,Beaver,4,35 to 44 Years,Male,10638,684,3847,2044,1316,2001,746,2747,4063,40.6834925,-80.3510736
01/01/2013 12:00:00 AM,42007,Southwest,Southwest Corner WDA,Beaver,4,35 to 44 Years,Male,9611,522,3205,1881,1286,1981,736,2717,4003,40.6834925,-80.3510736
01/01/2014 12:00:00 AM,42007,Southwest,Southwest Corner WDA,Beaver,4,35 to 44 Years,Male,9414,407,3312,1827,1252,1894,722,2616,3868,40.6834925,-80.3510736
01/01/2012 12:00:00 AM,42007,Southwest,Southwest Corner WDA,Beaver,4,35 to 44 Years,Male,9885,629,3277,2009,1352,1904,714,2618,3970,40.6834925,-80.3510736
01/01/2016 12:00:00 AM,42007,Southwest,Southwest Corner WDA,Beaver,4,35 to 44 Years,Male,9199,456,3235,1617,1301,1913,677,2590,3891,40.6834925,-80.3510736
01/01/2010 12:00:00 AM,42007,Southwest,Southwest Corner WDA,Beaver,4,25 to 34 Years,Female,8929,457,2398,1965,1492,1942,675,2617,4109,40.6834925,-80.3510736
01/01/2011 12:00:00 AM,42007,Southwest,Southwest Corner WDA,Beaver,4,35 to 44 Years,Male,10232,696,3430,1997,1461,1975,673,2648,4109,40.6834925,-80.3510736
01/01/2015 12:00:00 AM,42007,Southwest,Southwest Corner WDA,Beaver,4,35 to 44 Years,Male,9325,419,3392,1744,1284,1826,660,2486,3770,40.6834925,-80.3510736
01/01/2015 12:00:00 AM,42007,Southwest,Southwest Corner WDA,Beaver,4,25 to 34 Years,Male,9674,693,3029,2045,1274,1996,637,2633,3907,40.6834925,-80.3510736
01/01/2012 12:00:00 AM,42007,Southwest,Southwest Corner WDA,Beaver,4,25 to 34 Years,Male,9256,528,3056,1999,1275,1809,589,2398,3673,40.6834925,-80.3510736
01/01/2016 12:00:00 AM,42007,Southwest,Southwest Corner WDA,Beaver,4,25 to 34 Years,Male,9815,691,3014,2042,1262,2249,557,2806,4068,40.6834925,-80.3510736
01/01/2014 12:00:00 AM,42007,Southwest,Southwest Corner WDA,Beaver,4,25 to 34 Years,Male,9548,551,3147,1948,1364,1999,539,2538,3902,40.6834925,-80.3510736
01/01/2013 12:00:00 AM,42007,Southwest,Southwest Corner WDA,Beaver,4,25 to 34 Years,Male,9448,511,3174,2019,1354,1875,515,2390,3744,40.6834925,-80.3510736
01/01/2011 12:00:00 AM,42007,Southwest,Southwest Corner WDA,Beaver,4,25 to 34 Years,Male,9073,413,3229,2047,1147,1738,499,2237,3384,40.6834925,-80.3510736
01/01/2010 12:00:00 AM,42007,Southwest,Southwest Corner WDA,Beaver,4,25 to 34 Years,Male,8905,397,3463,1843,1081,1640,481,2121,3202,40.6834925,-80.3510736
01/01/2015 12:00:00 AM,42063,Southwest,Tri-County WDA,Indiana,32,45 to 64 Years,Male,12062,1139,5766,1604,979,1235,1339,2574,3553,40.652955,-79.0933349
01/01/2014 12:00:00 AM,42063,Southwest,Tri-County WDA,Indiana,32,45 to 64 Years,Male,12052,1201,5656,1663,946,1315,1271,2586,3532,40.652955,-79.0933349
01/01/2016 12:00:00 AM,42063,Southwest,Tri-County WDA,Indiana,32,45 to 64 Years,Male,11859,1005,5954,1479,1057,1158,1206,2364,3421,40.652955,-79.0933349
01/01/2013 12:00:00 AM,42063,Southwest,Tri-County WDA,Indiana,32,45 to 64 Years,Male,12066,1210,5751,1600,903,1433,1169,2602,3505,40.652955,-79.0933349
01/01/2014 12:00:00 AM,42063,Southwest,Tri-County WDA,Indiana,32,45 to 64 Years,Female,11757,752,5659,1566,1002,1621,1157,2778,3780,40.652955,-79.0933349
01/01/2016 12:00:00 AM,42063,Southwest,Tri-County WDA,Indiana,32,45 to 64 Years,Female,11574,791,5186,1763,1044,1659,1131,2790,3834,40.652955,-79.0933349
01/01/2013 12:00:00 AM,42063,Southwest,Tri-County WDA,Indiana,32,45 to 64 Years,Female,11791,775,5605,1736,1004,1551,1120,2671,3675,40.652955,-79.0933349
01/01/2015 12:00:00 AM,42063,Southwest,Tri-County WDA,Indiana,32,45 to 64 Years,Female,11683,778,5495,1713,970,1619,1108,2727,3697,40.652955,-79.0933349
01/01/2012 12:00:00 AM,42063,Southwest,Tri-County WDA,Indiana,32,45 to 64 Years,Female,11726,833,5887,1647,948,1394,1017,2411,3359,40.652955,-79.0933349
01/01/2012 12:00:00 AM,42063,Southwest,Tri-County WDA,Indiana,32,45 to 64 Years,Male,11891,1229,5803,1602,910,1368,979,2347,3257,40.652955,-79.0933349
01/01/2010 12:00:00 AM,42063,Southwest,Tri-County WDA,Indiana,32,45 to 64 Years,Female,11563,812,5974,1582,923,1335,937,2272,3195,40.652955,-79.0933349
01/01/2011 12:00:00 AM,42063,Southwest,Tri-County WDA,Indiana,32,45 to 64 Years,Female,11636,834,5941,1671,897,1364,929,2293,3190,40.652955,-79.0933349
01/01/2011 12:00:00 AM,42063,Southwest,Tri-County WDA,Indiana,32,45 to 64 Years,Male,11916,1201,5917,1609,895,1410,884,2294,3189,40.652955,-79.0933349
01/01/2010 12:00:00 AM,42063,Southwest,Tri-County WDA,Indiana,32,45 to 64 Years,Male,11811,1230,6026,1467,877,1469,742,2211,3088,40.652955,-79.0933349
01/01/2016 12:00:00 AM,42063,Southwest,Tri-County WDA,Indiana,32,35 to 44 Years,Female,4382,301,1377,701,630,792,581,1373,2003,40.652955,-79.0933349
01/01/2014 12:00:00 AM,42063,Southwest,Tri-County WDA,Indiana,32,35 to 44 Years,Female,4542,291,1574,720,560,854,543,1397,1957,40.652955,-79.0933349
01/01/2013 12:00:00 AM,42063,Southwest,Tri-County WDA,Indiana,32,35 to 44 Years,Female,4662,337,1649,738,533,869,536,1405,1938,40.652955,-79.0933349
01/01/2014 12:00:00 AM,42063,Southwest,Tri-County WDA,Indiana,32,25 to 34 Years,Female,4186,265,1020,770,545,1079,507,1586,2131,40.652955,-79.0933349
01/01/2011 12:00:00 AM,42063,Southwest,Tri-County WDA,Indiana,32,25 to 34 Years,Female,4111,280,1117,707,481,1037,489,1526,2007,40.652955,-79.0933349
01/01/2013 12:00:00 AM,42063,Southwest,Tri-County WDA,Indiana,32,25 to 34 Years,Female,4171,283,1034,798,580,990,486,1476,2056,40.652955,-79.0933349
01/01/2015 12:00:00 AM,42063,Southwest,Tri-County WDA,Indiana,32,35 to 44 Years,Female,4387,330,1563,671,614,735,474,1209,1823,40.652955,-79.0933349
01/01/2011 12:00:00 AM,42063,Southwest,Tri-County WDA,Indiana,32,35 to 44 Years,Female,4918,325,1845,875,480,935,458,1393,1873,40.652955,-79.0933349
01/01/2012 12:00:00 AM,42063,Southwest,Tri-County WDA,Indiana,32,25 to 34 Years,Female,4187,267,1112,752,540,1061,455,1516,2056,40.652955,-79.0933349
01/01/2012 12:00:00 AM,42063,Southwest,Tri-County WDA,Indiana,32,35 to 44 Years,Female,4816,335,1629,914,532,951,455,1406,1938,40.652955,-79.0933349
01/01/2015 12:00:00 AM,42063,Southwest,Tri-County WDA,Indiana,32,25 to 34 Years,Female,4163,349,1060,734,489,1088,443,1531,2020,40.652955,-79.0933349
01/01/2010 12:00:00 AM,42063,Southwest,Tri-County WDA,Indiana,32,25 to 34 Years,Female,4099,271,1200,700,507,998,423,1421,1928,40.652955,-79.0933349
01/01/2010 12:00:00 AM,42063,Southwest,Tri-County WDA,Indiana,32,35 to 44 Years,Female,4992,343,1965,919,572,777,416,1193,1765,40.652955,-79.0933349
01/01/2016 12:00:00 AM,42063,Southwest,Tri-County WDA,Indiana,32,25 to 34 Years,Female,4128,390,1097,735,466,1025,415,1440,1906,40.652955,-79.0933349
01/01/2016 12:00:00 AM,42063,Southwest,Tri-County WDA,Indiana,32,35 to 44 Years,Male,4380,472,1687,780,440,590,411,1001,1441,40.652955,-79.0933349
01/01/2012 12:00:00 AM,42063,Southwest,Tri-County WDA,Indiana,32,25 to 34 Years,Male,4818,504,1592,881,506,945,390,1335,1841,40.652955,-79.0933349
01/01/2012 12:00:00 AM,42063,Southwest,Tri-County WDA,Indiana,32,35 to 44 Years,Male,4812,417,2067,819,490,657,362,1019,1509,40.652955,-79.0933349
01/01/2015 12:00:00 AM,42063,Southwest,Tri-County WDA,Indiana,32,35 to 44 Years,Male,4502,430,1734,834,466,681,357,1038,1504,40.652955,-79.0933349
01/01/2014 12:00:00 AM,42063,Southwest,Tri-County WDA,Indiana,32,35 to 44 Years,Male,4604,416,1751,889,527,668,353,1021,1548,40.652955,-79.0933349
01/01/2011 12:00:00 AM,42063,Southwest,Tri-County WDA,Indiana,32,25 to 34 Years,Male,4659,651,1512,855,433,860,348,1208,1641,40.652955,-79.0933349
01/01/2013 12:00:00 AM,42063,Southwest,Tri-County WDA,Indiana,32,35 to 44 Years,Male,4699,376,2005,831,543,602,342,944,1487,40.652955,-79.0933349
01/01/2014 12:00:00 AM,42063,Southwest,Tri-County WDA,Indiana,32,25 to 34 Years,Male,4921,467,1510,919,579,1119,327,1446,2025,40.652955,-79.0933349
01/01/2015 12:00:00 AM,42063,Southwest,Tri-County WDA,Indiana,32,25 to 34 Years,Male,4893,541,1518,960,584,972,318,1290,1874,40.652955,-79.0933349
01/01/2013 12:00:00 AM,42063,Southwest,Tri-County WDA,Indiana,32,25 to 34 Years,Male,4859,590,1546,883,549,975,316,1291,1840,40.652955,-79.0933349
01/01/2011 12:00:00 AM,42063,Southwest,Tri-County WDA,Indiana,32,35 to 44 Years,Male,4926,447,2166,821,445,734,313,1047,1492,40.652955,-79.0933349
01/01/2010 12:00:00 AM,42063,Southwest,Tri-County WDA,Indiana,32,35 to 44 Years,Male,5085,558,2396,771,462,602,296,898,1360,40.652955,-79.0933349
01/01/2010 12:00:00 AM,42063,Southwest,Tri-County WDA,Indiana,32,25 to 34 Years,Male,4558,683,1487,940,441,782,225,1007,1448,40.652955,-79.0933349
01/01/2016 12:00:00 AM,42063,Southwest,Tri-County WDA,Indiana,32,25 to 34 Years,Male,4874,536,1581,1055,650,858,194,1052,1702,40.652955,-79.0933349
01/01/2011 12:00:00 AM,42077,Lehigh Valley,Lehigh Valley WDA,Lehigh,39,45 to 64 Years,Male,45974,5005,15772,7413,3637,7580,6567,14147,17784,40.6146479,-75.6009948
01/01/2012 12:00:00 AM,42077,Lehigh Valley,Lehigh Valley WDA,Lehigh,39,45 to 64 Years,Male,46653,5047,16034,7515,4012,7618,6427,14045,18057,40.6146479,-75.6009948
01/01/2010 12:00:00 AM,42077,Lehigh Valley,Lehigh Valley WDA,Lehigh,39,45 to 64 Years,Male,45084,4698,15453,7427,3596,7491,6419,13910,17506,40.6146479,-75.6009948
01/01/2013 12:00:00 AM,42077,Lehigh Valley,Lehigh Valley WDA,Lehigh,39,45 to 64 Years,Male,47129,5242,16265,7431,4207,7816,6168,13984,18191,40.6146479,-75.6009948
01/01/2015 12:00:00 AM,42077,Lehigh Valley,Lehigh Valley WDA,Lehigh,39,45 to 64 Years,Female,49704,4582,15861,9292,5528,8382,6059,14441,19969,40.6146479,-75.6009948
01/01/2015 12:00:00 AM,42077,Lehigh Valley,Lehigh Valley WDA,Lehigh,39,45 to 64 Years,Male,47409,5118,16195,7629,4325,8106,6036,14142,18467,40.6146479,-75.6009948
01/01/2014 12:00:00 AM,42077,Lehigh Valley,Lehigh Valley WDA,Lehigh,39,45 to 64 Years,Male,47365,5256,16550,7495,4268,7769,6027,13796,18064,40.6146479,-75.6009948
01/01/2016 12:00:00 AM,42077,Lehigh Valley,Lehigh Valley WDA,Lehigh,39,45 to 64 Years,Female,49611,4203,15792,9376,5676,8620,5944,14564,20240,40.6146479,-75.6009948
01/01/2016 12:00:00 AM,42077,Lehigh Valley,Lehigh Valley WDA,Lehigh,39,45 to 64 Years,Male,47150,4896,16491,7902,4309,7952,5600,13552,17861,40.6146479,-75.6009948
01/01/2014 12:00:00 AM,42077,Lehigh Valley,Lehigh Valley WDA,Lehigh,39,45 to 64 Years,Female,49623,4746,16445,9094,5233,8538,5567,14105,19338,40.6146479,-75.6009948
01/01/2013 12:00:00 AM,42077,Lehigh Valley,Lehigh Valley WDA,Lehigh,39,45 to 64 Years,Female,49360,4854,17025,8725,5075,8288,5393,13681,18756,40.6146479,-75.6009948
01/01/2011 12:00:00 AM,42077,Lehigh Valley,Lehigh Valley WDA,Lehigh,39,45 to 64 Years,Female,48330,5370,16871,8397,4432,8004,5256,13260,17692,40.6146479,-75.6009948
01/01/2010 12:00:00 AM,42077,Lehigh Valley,Lehigh Valley WDA,Lehigh,39,45 to 64 Years,Female,47377,4869,16800,8226,4626,7623,5233,12856,17482,40.6146479,-75.6009948
01/01/2012 12:00:00 AM,42077,Lehigh Valley,Lehigh Valley WDA,Lehigh,39,45 to 64 Years,Female,48959,5103,16822,8935,4853,8110,5136,13246,18099,40.6146479,-75.6009948
01/01/2010 12:00:00 AM,42077,Lehigh Valley,Lehigh Valley WDA,Lehigh,39,35 to 44 Years,Female,24259,2204,6644,4243,2971,4976,3221,8197,11168,40.6146479,-75.6009948
01/01/2011 12:00:00 AM,42077,Lehigh Valley,Lehigh Valley WDA,Lehigh,39,35 to 44 Years,Female,23933,2228,6217,4310,2949,5109,3120,8229,11178,40.6146479,-75.6009948
01/01/2013 12:00:00 AM,42077,Lehigh Valley,Lehigh Valley WDA,Lehigh,39,35 to 44 Years,Female,23049,1967,5938,4300,2862,5009,2973,7982,10844,40.6146479,-75.6009948
01/01/2016 12:00:00 AM,42077,Lehigh Valley,Lehigh Valley WDA,Lehigh,39,35 to 44 Years,Female,22392,1856,6079,4114,2607,4770,2966,7736,10343,40.6146479,-75.6009948
01/01/2016 12:00:00 AM,42077,Lehigh Valley,Lehigh Valley WDA,Lehigh,39,25 to 34 Years,Female,22955,1858,5328,4673,2528,5633,2935,8568,11096,40.6146479,-75.6009948
01/01/2012 12:00:00 AM,42077,Lehigh Valley,Lehigh Valley WDA,Lehigh,39,35 to 44 Years,Female,23518,2126,6071,4347,2868,5172,2934,8106,10974,40.6146479,-75.6009948
01/01/2013 12:00:00 AM,42077,Lehigh Valley,Lehigh Valley WDA,Lehigh,39,25 to 34 Years,Female,22010,1957,5045,4546,2139,5399,2924,8323,10462,40.6146479,-75.6009948
01/01/2014 12:00:00 AM,42077,Lehigh Valley,Lehigh Valley WDA,Lehigh,39,35 to 44 Years,Female,22748,1881,6354,4167,2777,4647,2922,7569,10346,40.6146479,-75.6009948
01/01/2011 12:00:00 AM,42077,Lehigh Valley,Lehigh Valley WDA,Lehigh,39,35 to 44 Years,Male,23101,2764,7253,4111,1947,4181,2845,7026,8973,40.6146479,-75.6009948
01/01/2013 12:00:00 AM,42077,Lehigh Valley,Lehigh Valley WDA,Lehigh,39,35 to 44 Years,Male,22542,2498,6989,3799,1896,4525,2835,7360,9256,40.6146479,-75.6009948
01/01/2012 12:00:00 AM,42077,Lehigh Valley,Lehigh Valley WDA,Lehigh,39,25 to 34 Years,Female,21701,2097,5290,4588,1940,4957,2829,7786,9726,40.6146479,-75.6009948
01/01/2015 12:00:00 AM,42077,Lehigh Valley,Lehigh Valley WDA,Lehigh,39,35 to 44 Years,Male,22231,2449,6950,3834,1906,4270,2822,7092,8998,40.6146479,-75.6009948
01/01/2015 12:00:00 AM,42077,Lehigh Valley,Lehigh Valley WDA,Lehigh,39,25 to 34 Years,Female,22691,1925,4988,4638,2588,5754,2798,8552,11140,40.6146479,-75.6009948
01/01/2014 12:00:00 AM,42077,Lehigh Valley,Lehigh Valley WDA,Lehigh,39,35 to 44 Years,Male,22359,2547,6686,4029,1794,4524,2779,7303,9097,40.6146479,-75.6009948
01/01/2012 12:00:00 AM,42077,Lehigh Valley,Lehigh Valley WDA,Lehigh,39,35 to 44 Years,Male,22800,2623,7127,4083,1847,4351,2769,7120,8967,40.6146479,-75.6009948
01/01/2015 12:00:00 AM,42077,Lehigh Valley,Lehigh Valley WDA,Lehigh,39,35 to 44 Years,Female,22534,2074,5948,4433,2677,4662,2740,7402,10079,40.6146479,-75.6009948
01/01/2014 12:00:00 AM,42077,Lehigh Valley,Lehigh Valley WDA,Lehigh,39,25 to 34 Years,Female,22393,1977,4938,4716,2246,5794,2722,8516,10762,40.6146479,-75.6009948
01/01/2010 12:00:00 AM,42077,Lehigh Valley,Lehigh Valley WDA,Lehigh,39,35 to 44 Years,Male,23376,2737,7688,3809,2024,4477,2641,7118,9142,40.6146479,-75.6009948
01/01/2011 12:00:00 AM,42077,Lehigh Valley,Lehigh Valley WDA,Lehigh,39,25 to 34 Years,Female,21275,1997,5336,4455,2072,4828,2587,7415,9487,40.6146479,-75.6009948
01/01/2016 12:00:00 AM,42077,Lehigh Valley,Lehigh Valley WDA,Lehigh,39,35 to 44 Years,Male,22179,2243,6658,3668,2198,4840,2572,7412,9610,40.6146479,-75.6009948
01/01/2010 12:00:00 AM,42077,Lehigh Valley,Lehigh Valley WDA,Lehigh,39,25 to 34 Years,Female,20953,2198,5228,4501,1983,4528,2515,7043,9026,40.6146479,-75.6009948
01/01/2015 12:00:00 AM,42077,Lehigh Valley,Lehigh Valley WDA,Lehigh,39,25 to 34 Years,Male,22312,2532,6890,4010,2108,4943,1829,6772,8880,40.6146479,-75.6009948
01/01/2014 12:00:00 AM,42077,Lehigh Valley,Lehigh Valley WDA,Lehigh,39,25 to 34 Years,Male,21919,2616,6659,4072,1942,4806,1824,6630,8572,40.6146479,-75.6009948
01/01/2016 12:00:00 AM,42077,Lehigh Valley,Lehigh Valley WDA,Lehigh,39,25 to 34 Years,Male,22715,2554,7155,4305,2048,4876,1777,6653,8701,40.6146479,-75.6009948
01/01/2013 12:00:00 AM,42077,Lehigh Valley,Lehigh Valley WDA,Lehigh,39,25 to 34 Years,Male,21466,2692,6619,3878,1721,4838,1718,6556,8277,40.6146479,-75.6009948
01/01/2012 12:00:00 AM,42077,Lehigh Valley,Lehigh Valley WDA,Lehigh,39,25 to 34 Years,Male,21103,2557,6417,4031,1843,4580,1675,6255,8098,40.6146479,-75.6009948
01/01/2011 12:00:00 AM,42077,Lehigh Valley,Lehigh Valley WDA,Lehigh,39,25 to 34 Years,Male,20791,2486,6336,3926,1918,4468,1657,6125,8043,40.6146479,-75.6009948
01/01/2010 12:00:00 AM,42077,Lehigh Valley,Lehigh Valley WDA,Lehigh,39,25 to 34 Years,Male,20484,2175,6387,4096,2027,4178,1621,5799,7826,40.6146479,-75.6009948
01/01/2011 12:00:00 AM,42087,Central,Central WDA,Mifflin,44,45 to 64 Years,Female,6601,1029,3605,896,333,438,300,738,1071,40.6127493,-77.6200309
01/01/2011 12:00:00 AM,42087,Central,Central WDA,Mifflin,44,45 to 64 Years,Male,6346,857,3584,844,277,498,286,784,1061,40.6127493,-77.6200309
01/01/2010 12:00:00 AM,42087,Central,Central WDA,Mifflin,44,45 to 64 Years,Female,6492,1092,3701,754,266,400,279,679,945,40.6127493,-77.6200309
01/01/2010 12:00:00 AM,42087,Central,Central WDA,Mifflin,44,45 to 64 Years,Male,6221,950,3507,709,278,508,269,777,1055,40.6127493,-77.6200309
01/01/2016 12:00:00 AM,42087,Central,Central WDA,Mifflin,44,45 to 64 Years,Female,6525,929,3485,971,414,473,253,726,1140,40.6127493,-77.6200309
01/01/2014 12:00:00 AM,42087,Central,Central WDA,Mifflin,44,45 to 64 Years,Male,6491,1033,3339,1017,378,475,249,724,1102,40.6127493,-77.6200309
01/01/2013 12:00:00 AM,42087,Central,Central WDA,Mifflin,44,45 to 64 Years,Female,6604,904,3610,973,436,435,246,681,1117,40.6127493,-77.6200309
01/01/2012 12:00:00 AM,42087,Central,Central WDA,Mifflin,44,45 to 64 Years,Male,6416,930,3642,823,293,483,245,728,1021,40.6127493,-77.6200309
01/01/2015 12:00:00 AM,42087,Central,Central WDA,Mifflin,44,45 to 64 Years,Female,6580,877,3552,1010,466,446,229,675,1141,40.6127493,-77.6200309
01/01/2012 12:00:00 AM,42087,Central,Central WDA,Mifflin,44,45 to 64 Years,Female,6619,965,3581,1006,360,480,227,707,1067,40.6127493,-77.6200309
01/01/2015 12:00:00 AM,42087,Central,Central WDA,Mifflin,44,45 to 64 Years,Male,6500,1010,3458,1034,357,420,221,641,998,40.6127493,-77.6200309
01/01/2014 12:00:00 AM,42087,Central,Central WDA,Mifflin,44,45 to 64 Years,Female,6600,802,3736,1038,404,406,214,620,1024,40.6127493,-77.6200309
01/01/2016 12:00:00 AM,42087,Central,Central WDA,Mifflin,44,45 to 64 Years,Male,6429,946,3556,972,323,425,207,632,955,40.6127493,-77.6200309
01/01/2013 12:00:00 AM,42087,Central,Central WDA,Mifflin,44,45 to 64 Years,Male,6470,1008,3443,1018,337,467,197,664,1001,40.6127493,-77.6200309
01/01/2013 12:00:00 AM,42087,Central,Central WDA,Mifflin,44,35 to 44 Years,Female,2924,406,1110,500,380,353,175,528,908,40.6127493,-77.6200309
01/01/2012 12:00:00 AM,42087,Central,Central WDA,Mifflin,44,35 to 44 Years,Female,3005,356,1299,427,418,344,161,505,923,40.6127493,-77.6200309
01/01/2011 12:00:00 AM,42087,Central,Central WDA,Mifflin,44,35 to 44 Years,Female,3063,360,1429,392,397,327,158,485,882,40.6127493,-77.6200309
01/01/2014 12:00:00 AM,42087,Central,Central WDA,Mifflin,44,35 to 44 Years,Female,2820,392,1115,463,310,385,155,540,850,40.6127493,-77.6200309
01/01/2015 12:00:00 AM,42087,Central,Central WDA,Mifflin,44,35 to 44 Years,Female,2767,376,1039,525,349,338,140,478,827,40.6127493,-77.6200309
01/01/2016 12:00:00 AM,42087,Central,Central WDA,Mifflin,44,35 to 44 Years,Female,2697,316,1100,448,331,375,127,502,833,40.6127493,-77.6200309
01/01/2010 12:00:00 AM,42087,Central,Central WDA,Mifflin,44,35 to 44 Years,Male,3083,360,1575,405,352,266,125,391,743,40.6127493,-77.6200309
01/01/2011 12:00:00 AM,42087,Central,Central WDA,Mifflin,44,35 to 44 Years,Male,2999,364,1544,390,360,223,118,341,701,40.6127493,-77.6200309
01/01/2016 12:00:00 AM,42087,Central,Central WDA,Mifflin,44,25 to 34 Years,Female,2493,261,926,401,395,394,116,510,905,40.6127493,-77.6200309
01/01/2010 12:00:00 AM,42087,Central,Central WDA,Mifflin,44,25 to 34 Years,Female,2505,424,957,476,303,229,116,345,648,40.6127493,-77.6200309
01/01/2010 12:00:00 AM,42087,Central,Central WDA,Mifflin,44,35 to 44 Years,Female,3095,304,1531,350,398,403,109,512,910,40.6127493,-77.6200309
01/01/2012 12:00:00 AM,42087,Central,Central WDA,Mifflin,44,35 to 44 Years,Male,2909,373,1463,381,375,217,100,317,692,40.6127493,-77.6200309
01/01/2010 12:00:00 AM,42087,Central,Central WDA,Mifflin,44,25 to 34 Years,Male,2339,399,1123,387,175,156,99,255,430,40.6127493,-77.6200309
01/01/2013 12:00:00 AM,42087,Central,Central WDA,Mifflin,44,35 to 44 Years,Male,2787,335,1355,413,325,264,95,359,684,40.6127493,-77.6200309
01/01/2013 12:00:00 AM,42087,Central,Central WDA,Mifflin,44,25 to 34 Years,Male,2457,472,1151,306,235,213,80,293,528,40.6127493,-77.6200309
01/01/2014 12:00:00 AM,42087,Central,Central WDA,Mifflin,44,25 to 34 Years,Male,2495,528,1136,235,228,290,78,368,596,40.6127493,-77.6200309
01/01/2011 12:00:00 AM,42087,Central,Central WDA,Mifflin,44,25 to 34 Years,Female,2480,425,845,541,330,265,74,339,669,40.6127493,-77.6200309
01/01/2012 12:00:00 AM,42087,Central,Central WDA,Mifflin,44,25 to 34 Years,Male,2388,474,1031,352,269,193,69,262,531,40.6127493,-77.6200309
01/01/2011 12:00:00 AM,42087,Central,Central WDA,Mifflin,44,25 to 34 Years,Male,2356,482,1031,366,238,171,68,239,477,40.6127493,-77.6200309
01/01/2015 12:00:00 AM,42087,Central,Central WDA,Mifflin,44,25 to 34 Years,Female,2477,324,838,453,374,425,63,488,862,40.6127493,-77.6200309
01/01/2012 12:00:00 AM,42087,Central,Central WDA,Mifflin,44,25 to 34 Years,Female,2422,406,747,517,327,369,56,425,752,40.6127493,-77.6200309
01/01/2014 12:00:00 AM,42087,Central,Central WDA,Mifflin,44,35 to 44 Years,Male,2705,329,1401,361,260,299,55,354,614,40.6127493,-77.6200309
01/01/2014 12:00:00 AM,42087,Central,Central WDA,Mifflin,44,25 to 34 Years,Female,2468,409,752,467,410,380,50,430,840,40.6127493,-77.6200309
01/01/2013 12:00:00 AM,42087,Central,Central WDA,Mifflin,44,25 to 34 Years,Female,2451,356,730,560,418,340,47,387,805,40.6127493,-77.6200309
01/01/2015 12:00:00 AM,42087,Central,Central WDA,Mifflin,44,25 to 34 Years,Male,2531,573,1084,295,224,315,40,355,579,40.6127493,-77.6200309
01/01/2015 12:00:00 AM,42087,Central,Central WDA,Mifflin,44,35 to 44 Years,Male,2611,337,1353,355,235,291,40,331,566,40.6127493,-77.6200309
01/01/2016 12:00:00 AM,42087,Central,Central WDA,Mifflin,44,25 to 34 Years,Male,2563,493,1076,402,190,367,35,402,592,40.6127493,-77.6200309
01/01/2016 12:00:00 AM,42087,Central,Central WDA,Mifflin,44,35 to 44 Years,Male,2543,349,1295,320,255,293,31,324,579,40.6127493,-77.6200309
01/01/2015 12:00:00 AM,42067,Central,South Central WDA,Juniata,34,45 to 64 Years,Female,3422,369,1848,494,256,257,198,455,711,40.5343301,-77.405775
01/01/2014 12:00:00 AM,42067,Central,South Central WDA,Juniata,34,45 to 64 Years,Female,3414,384,1887,444,248,261,190,451,699,40.5343301,-77.405775
01/01/2013 12:00:00 AM,42067,Central,South Central WDA,Juniata,34,45 to 64 Years,Female,3343,381,1896,441,232,215,178,393,625,40.5343301,-77.405775
01/01/2016 12:00:00 AM,42067,Central,South Central WDA,Juniata,34,45 to 64 Years,Female,3421,353,1842,433,293,323,177,500,793,40.5343301,-77.405775
01/01/2012 12:00:00 AM,42067,Central,South Central WDA,Juniata,34,45 to 64 Years,Female,3333,447,1882,454,186,187,177,364,550,40.5343301,-77.405775
01/01/2011 12:00:00 AM,42067,Central,South Central WDA,Juniata,34,45 to 64 Years,Female,3291,437,1894,407,188,190,175,365,553,40.5343301,-77.405775
01/01/2010 12:00:00 AM,42067,Central,South Central WDA,Juniata,34,45 to 64 Years,Female,3218,451,1830,342,204,228,163,391,595,40.5343301,-77.405775
01/01/2016 12:00:00 AM,42067,Central,South Central WDA,Juniata,34,45 to 64 Years,Male,3479,459,2040,354,224,279,123,402,626,40.5343301,-77.405775
01/01/2013 12:00:00 AM,42067,Central,South Central WDA,Juniata,34,45 to 64 Years,Male,3481,385,2095,362,243,275,121,396,639,40.5343301,-77.405775
01/01/2015 12:00:00 AM,42067,Central,South Central WDA,Juniata,34,45 to 64 Years,Male,3492,440,2001,360,281,291,119,410,691,40.5343301,-77.405775
01/01/2010 12:00:00 AM,42067,Central,South Central WDA,Juniata,34,45 to 64 Years,Male,3336,615,1851,343,184,230,113,343,527,40.5343301,-77.405775
01/01/2011 12:00:00 AM,42067,Central,South Central WDA,Juniata,34,45 to 64 Years,Male,3405,507,1955,338,212,285,108,393,605,40.5343301,-77.405775
01/01/2012 12:00:00 AM,42067,Central,South Central WDA,Juniata,34,45 to 64 Years,Male,3442,437,1995,366,260,276,108,384,644,40.5343301,-77.405775
01/01/2014 12:00:00 AM,42067,Central,South Central WDA,Juniata,34,45 to 64 Years,Male,3469,402,2050,368,268,277,104,381,649,40.5343301,-77.405775
01/01/2015 12:00:00 AM,42067,Central,South Central WDA,Juniata,34,25 to 34 Years,Male,1397,265,571,150,155,162,94,256,411,40.5343301,-77.405775
01/01/2016 12:00:00 AM,42067,Central,South Central WDA,Juniata,34,35 to 44 Years,Female,1406,223,588,213,151,139,92,231,382,40.5343301,-77.405775
01/01/2015 12:00:00 AM,42067,Central,South Central WDA,Juniata,34,25 to 34 Years,Female,1303,201,480,196,111,225,90,315,426,40.5343301,-77.405775
01/01/2016 12:00:00 AM,42067,Central,South Central WDA,Juniata,34,25 to 34 Years,Female,1316,201,468,209,128,223,87,310,438,40.5343301,-77.405775
01/01/2014 12:00:00 AM,42067,Central,South Central WDA,Juniata,34,25 to 34 Years,Female,1313,173,536,172,147,203,82,285,432,40.5343301,-77.405775
01/01/2016 12:00:00 AM,42067,Central,South Central WDA,Juniata,34,25 to 34 Years,Male,1413,254,633,136,162,146,82,228,390,40.5343301,-77.405775
01/01/2013 12:00:00 AM,42067,Central,South Central WDA,Juniata,34,25 to 34 Years,Female,1335,104,568,244,133,208,78,286,419,40.5343301,-77.405775
01/01/2013 12:00:00 AM,42067,Central,South Central WDA,Juniata,34,25 to 34 Years,Male,1385,208,636,111,155,199,76,275,430,40.5343301,-77.405775
01/01/2014 12:00:00 AM,42067,Central,South Central WDA,Juniata,34,25 to 34 Years,Male,1380,246,606,109,178,165,76,241,419,40.5343301,-77.405775
01/01/2010 12:00:00 AM,42067,Central,South Central WDA,Juniata,34,35 to 44 Years,Female,1624,144,762,258,229,163,68,231,460,40.5343301,-77.405775
01/01/2015 12:00:00 AM,42067,Central,South Central WDA,Juniata,34,35 to 44 Years,Female,1443,223,666,222,136,128,68,196,332,40.5343301,-77.405775
01/01/2012 12:00:00 AM,42067,Central,South Central WDA,Juniata,34,25 to 34 Years,Female,1355,115,548,311,134,182,65,247,381,40.5343301,-77.405775
01/01/2010 12:00:00 AM,42067,Central,South Central WDA,Juniata,34,35 to 44 Years,Male,1671,217,900,265,90,137,62,199,289,40.5343301,-77.405775
01/01/2014 12:00:00 AM,42067,Central,South Central WDA,Juniata,34,35 to 44 Years,Female,1480,187,710,247,151,124,61,185,336,40.5343301,-77.405775
01/01/2011 12:00:00 AM,42067,Central,South Central WDA,Juniata,34,25 to 34 Years,Female,1360,143,541,274,179,164,59,223,402,40.5343301,-77.405775
01/01/2011 12:00:00 AM,42067,Central,South Central WDA,Juniata,34,35 to 44 Years,Male,1642,199,940,238,72,135,58,193,265,40.5343301,-77.405775
01/01/2010 12:00:00 AM,42067,Central,South Central WDA,Juniata,34,25 to 34 Years,Female,1341,159,548,232,205,143,54,197,402,40.5343301,-77.405775
01/01/2013 12:00:00 AM,42067,Central,South Central WDA,Juniata,34,35 to 44 Years,Female,1501,185,737,230,199,96,54,150,349,40.5343301,-77.405775
01/01/2012 12:00:00 AM,42067,Central,South Central WDA,Juniata,34,35 to 44 Years,Female,1554,158,795,213,213,126,49,175,388,40.5343301,-77.405775
01/01/2015 12:00:00 AM,42067,Central,South Central WDA,Juniata,34,35 to 44 Years,Male,1470,349,788,139,65,81,48,129,194,40.5343301,-77.405775
01/01/2011 12:00:00 AM,42067,Central,South Central WDA,Juniata,34,35 to 44 Years,Female,1592,149,817,249,183,148,46,194,377,40.5343301,-77.405775
01/01/2014 12:00:00 AM,42067,Central,South Central WDA,Juniata,34,35 to 44 Years,Male,1510,315,794,186,74,95,46,141,215,40.5343301,-77.405775
01/01/2013 12:00:00 AM,42067,Central,South Central WDA,Juniata,34,35 to 44 Years,Male,1535,248,899,175,77,92,44,136,213,40.5343301,-77.405775
01/01/2012 12:00:00 AM,42067,Central,South Central WDA,Juniata,34,35 to 44 Years,Male,1589,209,931,235,84,93,37,130,214,40.5343301,-77.405775
01/01/2016 12:00:00 AM,42067,Central,South Central WDA,Juniata,34,35 to 44 Years,Male,1450,345,747,156,54,112,36,148,202,40.5343301,-77.405775
01/01/2012 12:00:00 AM,42067,Central,South Central WDA,Juniata,34,25 to 34 Years,Male,1378,205,706,123,120,194,30,224,344,40.5343301,-77.405775
01/01/2010 12:00:00 AM,42067,Central,South Central WDA,Juniata,34,25 to 34 Years,Male,1371,175,756,112,147,167,14,181,328,40.5343301,-77.405775
01/01/2011 12:00:00 AM,42067,Central,South Central WDA,Juniata,34,25 to 34 Years,Male,1383,232,705,106,115,214,11,225,340,40.5343301,-77.405775
01/01/2010 12:00:00 AM,42021,Southwest,Southern Alleghenies WDA,Cambria,11,45 to 64 Years,Male,21151,1837,10874,2812,1509,2437,1682,4119,5628,40.4912749,-78.7189417
01/01/2011 12:00:00 AM,42021,Southwest,Southern Alleghenies WDA,Cambria,11,45 to 64 Years,Male,21401,1803,11195,3029,1425,2423,1526,3949,5374,40.4912749,-78.7189417
01/01/2015 12:00:00 AM,42021,Southwest,Southern Alleghenies WDA,Cambria,11,45 to 64 Years,Male,20830,1426,10559,2885,1688,2761,1511,4272,5960,40.4912749,-78.7189417
01/01/2016 12:00:00 AM,42021,Southwest,Southern Alleghenies WDA,Cambria,11,45 to 64 Years,Female,19983,1187,9540,3080,2254,2428,1494,3922,6176,40.4912749,-78.7189417
01/01/2015 12:00:00 AM,42021,Southwest,Southern Alleghenies WDA,Cambria,11,45 to 64 Years,Female,20381,1304,9811,3275,2294,2252,1445,3697,5991,40.4912749,-78.7189417
01/01/2014 12:00:00 AM,42021,Southwest,Southern Alleghenies WDA,Cambria,11,45 to 64 Years,Male,21089,1548,10971,2818,1672,2644,1436,4080,5752,40.4912749,-78.7189417
01/01/2016 12:00:00 AM,42021,Southwest,Southern Alleghenies WDA,Cambria,11,45 to 64 Years,Male,20382,1407,10279,2770,1746,2748,1432,4180,5926,40.4912749,-78.7189417
01/01/2010 12:00:00 AM,42021,Southwest,Southern Alleghenies WDA,Cambria,11,45 to 64 Years,Female,20811,1380,10433,2930,2200,2456,1412,3868,6068,40.4912749,-78.7189417
01/01/2012 12:00:00 AM,42021,Southwest,Southern Alleghenies WDA,Cambria,11,45 to 64 Years,Male,21419,1703,11283,2981,1489,2565,1398,3963,5452,40.4912749,-78.7189417
01/01/2014 12:00:00 AM,42021,Southwest,Southern Alleghenies WDA,Cambria,11,45 to 64 Years,Female,20663,1415,9961,3309,2289,2329,1360,3689,5978,40.4912749,-78.7189417
01/01/2013 12:00:00 AM,42021,Southwest,Southern Alleghenies WDA,Cambria,11,45 to 64 Years,Male,21381,1597,11260,3047,1521,2645,1311,3956,5477,40.4912749,-78.7189417
01/01/2011 12:00:00 AM,42021,Southwest,Southern Alleghenies WDA,Cambria,11,45 to 64 Years,Female,20932,1481,10391,3149,2300,2304,1307,3611,5911,40.4912749,-78.7189417
01/01/2012 12:00:00 AM,42021,Southwest,Southern Alleghenies WDA,Cambria,11,45 to 64 Years,Female,20970,1442,10294,3233,2365,2372,1264,3636,6001,40.4912749,-78.7189417
01/01/2013 12:00:00 AM,42021,Southwest,Southern Alleghenies WDA,Cambria,11,45 to 64 Years,Female,20898,1349,10244,3338,2351,2444,1172,3616,5967,40.4912749,-78.7189417
01/01/2014 12:00:00 AM,42021,Southwest,Southern Alleghenies WDA,Cambria,11,35 to 44 Years,Female,7812,341,2391,1306,1354,1537,883,2420,3774,40.4912749,-78.7189417
01/01/2016 12:00:00 AM,42021,Southwest,Southern Alleghenies WDA,Cambria,11,35 to 44 Years,Female,7623,312,2168,1377,1509,1425,832,2257,3766,40.4912749,-78.7189417
01/01/2013 12:00:00 AM,42021,Southwest,Southern Alleghenies WDA,Cambria,11,35 to 44 Years,Female,7903,316,2515,1354,1380,1524,814,2338,3718,40.4912749,-78.7189417
01/01/2015 12:00:00 AM,42021,Southwest,Southern Alleghenies WDA,Cambria,11,35 to 44 Years,Female,7700,323,2290,1370,1571,1361,785,2146,3717,40.4912749,-78.7189417
01/01/2012 12:00:00 AM,42021,Southwest,Southern Alleghenies WDA,Cambria,11,35 to 44 Years,Female,8100,300,2699,1543,1273,1515,770,2285,3558,40.4912749,-78.7189417
01/01/2016 12:00:00 AM,42021,Southwest,Southern Alleghenies WDA,Cambria,11,25 to 34 Years,Female,6908,356,1668,1367,1261,1501,755,2256,3517,40.4912749,-78.7189417
01/01/2010 12:00:00 AM,42021,Southwest,Southern Alleghenies WDA,Cambria,11,35 to 44 Years,Female,8617,383,3227,1587,1395,1277,748,2025,3420,40.4912749,-78.7189417
01/01/2011 12:00:00 AM,42021,Southwest,Southern Alleghenies WDA,Cambria,11,35 to 44 Years,Female,8404,361,3044,1569,1264,1431,735,2166,3430,40.4912749,-78.7189417
01/01/2013 12:00:00 AM,42021,Southwest,Southern Alleghenies WDA,Cambria,11,35 to 44 Years,Male,8783,772,3657,1676,884,1081,713,1794,2678,40.4912749,-78.7189417
01/01/2016 12:00:00 AM,42021,Southwest,Southern Alleghenies WDA,Cambria,11,35 to 44 Years,Male,7815,599,3174,1461,752,1131,698,1829,2581,40.4912749,-78.7189417
01/01/2013 12:00:00 AM,42021,Southwest,Southern Alleghenies WDA,Cambria,11,25 to 34 Years,Female,7116,357,1900,1423,1233,1519,684,2203,3436,40.4912749,-78.7189417
01/01/2014 12:00:00 AM,42021,Southwest,Southern Alleghenies WDA,Cambria,11,25 to 34 Years,Female,7120,392,1739,1480,1241,1594,674,2268,3509,40.4912749,-78.7189417
01/01/2014 12:00:00 AM,42021,Southwest,Southern Alleghenies WDA,Cambria,11,35 to 44 Years,Male,8460,785,3490,1521,841,1161,662,1823,2664,40.4912749,-78.7189417
01/01/2012 12:00:00 AM,42021,Southwest,Southern Alleghenies WDA,Cambria,11,35 to 44 Years,Male,8995,750,3865,1667,960,1121,632,1753,2713,40.4912749,-78.7189417
01/01/2012 12:00:00 AM,42021,Southwest,Southern Alleghenies WDA,Cambria,11,25 to 34 Years,Female,7121,270,1996,1480,1242,1503,630,2133,3375,40.4912749,-78.7189417
01/01/2015 12:00:00 AM,42021,Southwest,Southern Alleghenies WDA,Cambria,11,25 to 34 Years,Female,7056,418,1835,1431,1189,1560,623,2183,3372,40.4912749,-78.7189417
01/01/2015 12:00:00 AM,42021,Southwest,Southern Alleghenies WDA,Cambria,11,35 to 44 Years,Male,8130,700,3444,1457,807,1114,608,1722,2529,40.4912749,-78.7189417
01/01/2010 12:00:00 AM,42021,Southwest,Southern Alleghenies WDA,Cambria,11,25 to 34 Years,Female,7197,327,2380,1225,1296,1395,574,1969,3265,40.4912749,-78.7189417
01/01/2011 12:00:00 AM,42021,Southwest,Southern Alleghenies WDA,Cambria,11,35 to 44 Years,Male,9264,713,4188,1765,929,1121,548,1669,2598,40.4912749,-78.7189417
01/01/2011 12:00:00 AM,42021,Southwest,Southern Alleghenies WDA,Cambria,11,25 to 34 Years,Female,7157,323,2167,1431,1290,1411,535,1946,3236,40.4912749,-78.7189417
01/01/2010 12:00:00 AM,42021,Southwest,Southern Alleghenies WDA,Cambria,11,35 to 44 Years,Male,9440,877,4483,1626,844,1075,535,1610,2454,40.4912749,-78.7189417
01/01/2016 12:00:00 AM,42021,Southwest,Southern Alleghenies WDA,Cambria,11,25 to 34 Years,Male,7453,536,2956,1468,796,1257,440,1697,2493,40.4912749,-78.7189417
01/01/2011 12:00:00 AM,42021,Southwest,Southern Alleghenies WDA,Cambria,11,25 to 34 Years,Male,8035,687,3325,1321,942,1343,417,1760,2702,40.4912749,-78.7189417
01/01/2010 12:00:00 AM,42021,Southwest,Southern Alleghenies WDA,Cambria,11,25 to 34 Years,Male,8037,610,3310,1338,961,1402,416,1818,2779,40.4912749,-78.7189417
01/01/2014 12:00:00 AM,42021,Southwest,Southern Alleghenies WDA,Cambria,11,25 to 34 Years,Male,7716,597,3115,1527,832,1238,407,1645,2477,40.4912749,-78.7189417
01/01/2015 12:00:00 AM,42021,Southwest,Southern Alleghenies WDA,Cambria,11,25 to 34 Years,Male,7541,636,3121,1422,818,1140,404,1544,2362,40.4912749,-78.7189417
01/01/2012 12:00:00 AM,42021,Southwest,Southern Alleghenies WDA,Cambria,11,25 to 34 Years,Male,7946,666,3267,1407,902,1352,352,1704,2606,40.4912749,-78.7189417
01/01/2013 12:00:00 AM,42021,Southwest,Southern Alleghenies WDA,Cambria,11,25 to 34 Years,Male,7933,609,3227,1500,930,1352,315,1667,2597,40.4912749,-78.7189417
01/01/2013 12:00:00 AM,42013,Southwest,Southern Alleghenies WDA,Blair,7,45 to 64 Years,Male,17706,1153,9295,2764,1255,1870,1369,3239,4494,40.4855502,-78.3490769
01/01/2015 12:00:00 AM,42013,Southwest,Southern Alleghenies WDA,Blair,7,45 to 64 Years,Female,18313,1078,9091,2758,1858,2200,1328,3528,5386,40.4855502,-78.3490769
01/01/2016 12:00:00 AM,42013,Southwest,Southern Alleghenies WDA,Blair,7,45 to 64 Years,Female,18132,1168,8826,2802,1754,2293,1289,3582,5336,40.4855502,-78.3490769
01/01/2012 12:00:00 AM,42013,Southwest,Southern Alleghenies WDA,Blair,7,45 to 64 Years,Male,17693,1164,9006,2860,1331,2046,1286,3332,4663,40.4855502,-78.3490769
01/01/2014 12:00:00 AM,42013,Southwest,Southern Alleghenies WDA,Blair,7,45 to 64 Years,Male,17663,1347,9229,2683,1249,1870,1285,3155,4404,40.4855502,-78.3490769
01/01/2011 12:00:00 AM,42013,Southwest,Southern Alleghenies WDA,Blair,7,45 to 64 Years,Male,17646,1349,8914,2704,1257,2174,1248,3422,4679,40.4855502,-78.3490769
01/01/2010 12:00:00 AM,42013,Southwest,Southern Alleghenies WDA,Blair,7,45 to 64 Years,Male,17450,1298,8816,2709,1217,2200,1210,3410,4627,40.4855502,-78.3490769
01/01/2013 12:00:00 AM,42013,Southwest,Southern Alleghenies WDA,Blair,7,45 to 64 Years,Female,18504,896,9752,2878,1709,2060,1209,3269,4978,40.4855502,-78.3490769
01/01/2014 12:00:00 AM,42013,Southwest,Southern Alleghenies WDA,Blair,7,45 to 64 Years,Female,18460,1063,9334,2976,1805,2108,1174,3282,5087,40.4855502,-78.3490769
01/01/2015 12:00:00 AM,42013,Southwest,Southern Alleghenies WDA,Blair,7,45 to 64 Years,Male,17475,1265,9020,2609,1413,2078,1090,3168,4581,40.4855502,-78.3490769
01/01/2012 12:00:00 AM,42013,Southwest,Southern Alleghenies WDA,Blair,7,45 to 64 Years,Female,18472,889,9543,3056,1749,2168,1067,3235,4984,40.4855502,-78.3490769
01/01/2016 12:00:00 AM,42013,Southwest,Southern Alleghenies WDA,Blair,7,45 to 64 Years,Male,17238,1313,8983,2564,1305,2090,983,3073,4378,40.4855502,-78.3490769
01/01/2010 12:00:00 AM,42013,Southwest,Southern Alleghenies WDA,Blair,7,45 to 64 Years,Female,18198,1142,9653,2773,1775,1935,920,2855,4630,40.4855502,-78.3490769
01/01/2011 12:00:00 AM,42013,Southwest,Southern Alleghenies WDA,Blair,7,45 to 64 Years,Female,18403,1039,9517,3030,1774,2146,897,3043,4817,40.4855502,-78.3490769
01/01/2016 12:00:00 AM,42013,Southwest,Southern Alleghenies WDA,Blair,7,35 to 44 Years,Female,7375,292,2524,1333,1250,1224,752,1976,3226,40.4855502,-78.3490769
01/01/2010 12:00:00 AM,42013,Southwest,Southern Alleghenies WDA,Blair,7,35 to 44 Years,Female,8167,537,3060,1573,1052,1242,703,1945,2997,40.4855502,-78.3490769
01/01/2015 12:00:00 AM,42013,Southwest,Southern Alleghenies WDA,Blair,7,35 to 44 Years,Female,7455,360,2728,1117,1351,1253,646,1899,3250,40.4855502,-78.3490769
01/01/2011 12:00:00 AM,42013,Southwest,Southern Alleghenies WDA,Blair,7,35 to 44 Years,Female,7939,404,3145,1438,1192,1123,637,1760,2952,40.4855502,-78.3490769
01/01/2012 12:00:00 AM,42013,Southwest,Southern Alleghenies WDA,Blair,7,35 to 44 Years,Female,7746,442,3118,1188,1113,1251,634,1885,2998,40.4855502,-78.3490769
01/01/2014 12:00:00 AM,42013,Southwest,Southern Alleghenies WDA,Blair,7,35 to 44 Years,Female,7533,332,2922,1157,1235,1281,606,1887,3122,40.4855502,-78.3490769
01/01/2013 12:00:00 AM,42013,Southwest,Southern Alleghenies WDA,Blair,7,35 to 44 Years,Female,7632,357,2915,1178,1210,1369,603,1972,3182,40.4855502,-78.3490769
01/01/2015 12:00:00 AM,42013,Southwest,Southern Alleghenies WDA,Blair,7,25 to 34 Years,Female,7084,512,2346,1330,719,1680,497,2177,2896,40.4855502,-78.3490769
01/01/2016 12:00:00 AM,42013,Southwest,Southern Alleghenies WDA,Blair,7,25 to 34 Years,Female,7007,476,2297,1332,800,1625,477,2102,2902,40.4855502,-78.3490769
01/01/2016 12:00:00 AM,42013,Southwest,Southern Alleghenies WDA,Blair,7,35 to 44 Years,Male,7407,509,3228,1263,485,1447,475,1922,2407,40.4855502,-78.3490769
01/01/2011 12:00:00 AM,42013,Southwest,Southern Alleghenies WDA,Blair,7,25 to 34 Years,Female,7243,438,2257,1461,851,1769,467,2236,3087,40.4855502,-78.3490769
01/01/2013 12:00:00 AM,42013,Southwest,Southern Alleghenies WDA,Blair,7,25 to 34 Years,Female,7109,426,2357,1317,861,1686,462,2148,3009,40.4855502,-78.3490769
01/01/2014 12:00:00 AM,42013,Southwest,Southern Alleghenies WDA,Blair,7,25 to 34 Years,Female,7046,466,2294,1279,804,1742,461,2203,3007,40.4855502,-78.3490769
01/01/2012 12:00:00 AM,42013,Southwest,Southern Alleghenies WDA,Blair,7,25 to 34 Years,Female,7184,404,2416,1466,823,1616,459,2075,2898,40.4855502,-78.3490769
01/01/2015 12:00:00 AM,42013,Southwest,Southern Alleghenies WDA,Blair,7,35 to 44 Years,Male,7513,504,3264,1367,606,1317,455,1772,2378,40.4855502,-78.3490769
01/01/2013 12:00:00 AM,42013,Southwest,Southern Alleghenies WDA,Blair,7,35 to 44 Years,Male,7575,428,3473,1315,763,1146,450,1596,2359,40.4855502,-78.3490769
01/01/2014 12:00:00 AM,42013,Southwest,Southern Alleghenies WDA,Blair,7,35 to 44 Years,Male,7498,461,3454,1323,655,1166,439,1605,2260,40.4855502,-78.3490769
01/01/2010 12:00:00 AM,42013,Southwest,Southern Alleghenies WDA,Blair,7,25 to 34 Years,Female,7155,367,2237,1494,851,1799,407,2206,3057,40.4855502,-78.3490769
01/01/2012 12:00:00 AM,42013,Southwest,Southern Alleghenies WDA,Blair,7,35 to 44 Years,Male,7699,501,3622,1342,814,1034,386,1420,2234,40.4855502,-78.3490769
01/01/2016 12:00:00 AM,42013,Southwest,Southern Alleghenies WDA,Blair,7,25 to 34 Years,Male,7340,734,3143,1083,641,1368,371,1739,2380,40.4855502,-78.3490769
01/01/2010 12:00:00 AM,42013,Southwest,Southern Alleghenies WDA,Blair,7,35 to 44 Years,Male,7941,661,3851,1198,886,1005,340,1345,2231,40.4855502,-78.3490769
01/01/2011 12:00:00 AM,42013,Southwest,Southern Alleghenies WDA,Blair,7,35 to 44 Years,Male,7808,616,3799,1295,855,903,340,1243,2098,40.4855502,-78.3490769
01/01/2015 12:00:00 AM,42013,Southwest,Southern Alleghenies WDA,Blair,7,25 to 34 Years,Male,7171,607,3046,1170,527,1502,319,1821,2348,40.4855502,-78.3490769
01/01/2013 12:00:00 AM,42013,Southwest,Southern Alleghenies WDA,Blair,7,25 to 34 Years,Male,7087,528,2979,1308,520,1443,309,1752,2272,40.4855502,-78.3490769
01/01/2014 12:00:00 AM,42013,Southwest,Southern Alleghenies WDA,Blair,7,25 to 34 Years,Male,7096,597,3111,1184,504,1393,307,1700,2204,40.4855502,-78.3490769
01/01/2012 12:00:00 AM,42013,Southwest,Southern Alleghenies WDA,Blair,7,25 to 34 Years,Male,7149,548,3073,1369,472,1408,279,1687,2159,40.4855502,-78.3490769
01/01/2010 12:00:00 AM,42013,Southwest,Southern Alleghenies WDA,Blair,7,25 to 34 Years,Male,7176,486,3201,1330,742,1145,272,1417,2159,40.4855502,-78.3490769
01/01/2011 12:00:00 AM,42013,Southwest,Southern Alleghenies WDA,Blair,7,25 to 34 Years,Male,7095,516,3088,1355,593,1326,217,1543,2136,40.4855502,-78.3490769
01/01/2015 12:00:00 AM,42003,Southwest,Three Rivers WDA,Allegheny,2,45 to 64 Years,Male,166710,8340,52713,27786,16029,35686,26156,61842,77871,40.4673554,-79.9861984
01/01/2013 12:00:00 AM,42003,Southwest,Three Rivers WDA,Allegheny,2,45 to 64 Years,Male,167438,8842,54394,28189,14944,34923,26146,61069,76013,40.4673554,-79.9861984
01/01/2016 12:00:00 AM,42003,Southwest,Three Rivers WDA,Allegheny,2,45 to 64 Years,Male,164887,8425,51012,27658,15597,36168,26027,62195,77792,40.4673554,-79.9861984
01/01/2012 12:00:00 AM,42003,Southwest,Three Rivers WDA,Allegheny,2,45 to 64 Years,Male,167006,8467,54517,28608,14495,35042,25877,60919,75414,40.4673554,-79.9861984
01/01/2011 12:00:00 AM,42003,Southwest,Three Rivers WDA,Allegheny,2,45 to 64 Years,Male,166050,9051,54408,28434,14002,34345,25810,60155,74157,40.4673554,-79.9861984
01/01/2014 12:00:00 AM,42003,Southwest,Three Rivers WDA,Allegheny,2,45 to 64 Years,Male,167346,8392,53701,28247,15689,35517,25800,61317,77006,40.4673554,-79.9861984
01/01/2016 12:00:00 AM,42003,Southwest,Three Rivers WDA,Allegheny,2,45 to 64 Years,Female,178497,7745,53470,32422,22236,37123,25501,62624,84860,40.4673554,-79.9861984
01/01/2010 12:00:00 AM,42003,Southwest,Three Rivers WDA,Allegheny,2,45 to 64 Years,Male,164141,9214,52917,28401,14008,34122,25479,59601,73609,40.4673554,-79.9861984
01/01/2015 12:00:00 AM,42003,Southwest,Three Rivers WDA,Allegheny,2,45 to 64 Years,Female,180580,7750,56080,32958,21659,36677,25456,62133,83792,40.4673554,-79.9861984
01/01/2014 12:00:00 AM,42003,Southwest,Three Rivers WDA,Allegheny,2,45 to 64 Years,Female,181609,8093,57025,33742,21050,36664,25035,61699,82749,40.4673554,-79.9861984
01/01/2013 12:00:00 AM,42003,Southwest,Three Rivers WDA,Allegheny,2,45 to 64 Years,Female,181888,8039,58357,34484,21492,35461,24055,59516,81008,40.4673554,-79.9861984
01/01/2011 12:00:00 AM,42003,Southwest,Three Rivers WDA,Allegheny,2,45 to 64 Years,Female,180745,8165,61089,33670,20205,33561,24055,57616,77821,40.4673554,-79.9861984
01/01/2012 12:00:00 AM,42003,Southwest,Three Rivers WDA,Allegheny,2,45 to 64 Years,Female,181565,7789,59884,34233,20975,34907,23777,58684,79659,40.4673554,-79.9861984
01/01/2010 12:00:00 AM,42003,Southwest,Three Rivers WDA,Allegheny,2,45 to 64 Years,Female,179046,8485,62552,33452,19131,31699,23727,55426,74557,40.4673554,-79.9861984
01/01/2016 12:00:00 AM,42003,Southwest,Three Rivers WDA,Allegheny,2,25 to 34 Years,Female,89871,3327,12459,14025,9331,31146,19583,50729,60060,40.4673554,-79.9861984
01/01/2015 12:00:00 AM,42003,Southwest,Three Rivers WDA,Allegheny,2,25 to 34 Years,Female,87997,3244,12362,14470,9081,29831,19009,48840,57921,40.4673554,-79.9861984
01/01/2014 12:00:00 AM,42003,Southwest,Three Rivers WDA,Allegheny,2,25 to 34 Years,Female,85341,3088,12303,14533,9324,28381,17712,46093,55417,40.4673554,-79.9861984
01/01/2013 12:00:00 AM,42003,Southwest,Three Rivers WDA,Allegheny,2,25 to 34 Years,Female,82642,3321,11844,14530,9009,27065,16873,43938,52947,40.4673554,-79.9861984
01/01/2016 12:00:00 AM,42003,Southwest,Three Rivers WDA,Allegheny,2,35 to 44 Years,Female,70421,2465,11792,11287,9019,19509,16349,35858,44877,40.4673554,-79.9861984
01/01/2012 12:00:00 AM,42003,Southwest,Three Rivers WDA,Allegheny,2,25 to 34 Years,Female,79734,3055,11458,14452,8759,26007,16003,42010,50769,40.4673554,-79.9861984
01/01/2015 12:00:00 AM,42003,Southwest,Three Rivers WDA,Allegheny,2,35 to 44 Years,Female,71077,2725,12915,12039,9045,18711,15642,34353,43398,40.4673554,-79.9861984
01/01/2016 12:00:00 AM,42003,Southwest,Three Rivers WDA,Allegheny,2,25 to 34 Years,Male,92241,3390,17899,15830,8788,31324,15010,46334,55122,40.4673554,-79.9861984
01/01/2014 12:00:00 AM,42003,Southwest,Three Rivers WDA,Allegheny,2,35 to 44 Years,Female,71716,2518,13813,12251,9020,19112,15002,34114,43134,40.4673554,-79.9861984
01/01/2011 12:00:00 AM,42003,Southwest,Three Rivers WDA,Allegheny,2,25 to 34 Years,Female,77592,3309,11972,13621,8613,25125,14952,40077,48690,40.4673554,-79.9861984
01/01/2015 12:00:00 AM,42003,Southwest,Three Rivers WDA,Allegheny,2,25 to 34 Years,Male,89908,3781,17942,16045,8758,28950,14432,43382,52140,40.4673554,-79.9861984
01/01/2013 12:00:00 AM,42003,Southwest,Three Rivers WDA,Allegheny,2,35 to 44 Years,Female,72741,2716,14804,12748,8696,19390,14387,33777,42473,40.4673554,-79.9861984
01/01/2010 12:00:00 AM,42003,Southwest,Three Rivers WDA,Allegheny,2,25 to 34 Years,Female,75960,3437,12259,12917,8707,24775,13865,38640,47347,40.4673554,-79.9861984
01/01/2014 12:00:00 AM,42003,Southwest,Three Rivers WDA,Allegheny,2,25 to 34 Years,Male,86973,3586,17547,16451,8041,27796,13552,41348,49389,40.4673554,-79.9861984
01/01/2012 12:00:00 AM,42003,Southwest,Three Rivers WDA,Allegheny,2,35 to 44 Years,Female,74291,2819,15939,13400,9080,19568,13485,33053,42133,40.4673554,-79.9861984
01/01/2016 12:00:00 AM,42003,Southwest,Three Rivers WDA,Allegheny,2,35 to 44 Years,Male,70118,2960,15444,11524,7753,19011,13426,32437,40190,40.4673554,-79.9861984
01/01/2015 12:00:00 AM,42003,Southwest,Three Rivers WDA,Allegheny,2,35 to 44 Years,Male,70442,3228,16674,11523,7857,18055,13105,31160,39017,40.4673554,-79.9861984
01/01/2014 12:00:00 AM,42003,Southwest,Three Rivers WDA,Allegheny,2,35 to 44 Years,Male,70719,3155,17628,11609,7596,17722,13009,30731,38327,40.4673554,-79.9861984
01/01/2013 12:00:00 AM,42003,Southwest,Three Rivers WDA,Allegheny,2,35 to 44 Years,Male,71248,3007,18318,11882,7363,17822,12856,30678,38041,40.4673554,-79.9861984
01/01/2011 12:00:00 AM,42003,Southwest,Three Rivers WDA,Allegheny,2,35 to 44 Years,Female,76350,2931,17468,13729,9280,20138,12804,32942,42222,40.4673554,-79.9861984
01/01/2013 12:00:00 AM,42003,Southwest,Three Rivers WDA,Allegheny,2,25 to 34 Years,Male,83777,3462,17238,16184,8183,25915,12795,38710,46893,40.4673554,-79.9861984
01/01/2010 12:00:00 AM,42003,Southwest,Three Rivers WDA,Allegheny,2,35 to 44 Years,Male,75396,3268,20940,11954,7054,19581,12599,32180,39234,40.4673554,-79.9861984
01/01/2011 12:00:00 AM,42003,Southwest,Three Rivers WDA,Allegheny,2,35 to 44 Years,Male,73639,3171,20023,12242,6813,18842,12548,31390,38203,40.4673554,-79.9861984
01/01/2012 12:00:00 AM,42003,Southwest,Three Rivers WDA,Allegheny,2,25 to 34 Years,Male,80497,3284,16902,15771,8481,23610,12449,36059,44540,40.4673554,-79.9861984
01/01/2010 12:00:00 AM,42003,Southwest,Three Rivers WDA,Allegheny,2,35 to 44 Years,Female,78718,2908,19150,13984,9669,20588,12419,33007,42676,40.4673554,-79.9861984
01/01/2012 12:00:00 AM,42003,Southwest,Three Rivers WDA,Allegheny,2,35 to 44 Years,Male,72219,3010,19167,12364,6982,18304,12392,30696,37678,40.4673554,-79.9861984
01/01/2011 12:00:00 AM,42003,Southwest,Three Rivers WDA,Allegheny,2,25 to 34 Years,Male,78161,3515,17294,14914,7811,22588,12039,34627,42438,40.4673554,-79.9861984
01/01/2010 12:00:00 AM,42003,Southwest,Three Rivers WDA,Allegheny,2,25 to 34 Years,Male,76404,3190,16834,14316,8015,22734,11315,34049,42064,40.4673554,-79.9861984
01/01/2016 12:00:00 AM,42043,Central,South Central WDA,Dauphin,22,45 to 64 Years,Male,36779,3744,12741,6385,2987,6256,4666,10922,13909,40.4197464,-76.7796057
01/01/2013 12:00:00 AM,42043,Central,South Central WDA,Dauphin,22,45 to 64 Years,Male,37102,3537,13587,6105,2685,6540,4648,11188,13873,40.4197464,-76.7796057
01/01/2014 12:00:00 AM,42043,Central,South Central WDA,Dauphin,22,45 to 64 Years,Male,37147,3966,13477,5908,2839,6414,4543,10957,13796,40.4197464,-76.7796057
01/01/2015 12:00:00 AM,42043,Central,South Central WDA,Dauphin,22,45 to 64 Years,Male,37095,4064,13368,6127,2845,6173,4518,10691,13536,40.4197464,-76.7796057
01/01/2012 12:00:00 AM,42043,Central,South Central WDA,Dauphin,22,45 to 64 Years,Male,36900,3636,13486,5982,2843,6536,4417,10953,13796,40.4197464,-76.7796057
01/01/2010 12:00:00 AM,42043,Central,South Central WDA,Dauphin,22,45 to 64 Years,Male,35936,2935,13237,5565,2659,7127,4413,11540,14199,40.4197464,-76.7796057
01/01/2013 12:00:00 AM,42043,Central,South Central WDA,Dauphin,22,45 to 64 Years,Female,39876,3304,15320,7217,3845,5791,4399,10190,14035,40.4197464,-76.7796057
01/01/2011 12:00:00 AM,42043,Central,South Central WDA,Dauphin,22,45 to 64 Years,Male,36572,3263,13821,5735,2711,6760,4282,11042,13753,40.4197464,-76.7796057
01/01/2012 12:00:00 AM,42043,Central,South Central WDA,Dauphin,22,45 to 64 Years,Female,39575,3387,15568,6955,3884,5528,4253,9781,13665,40.4197464,-76.7796057
01/01/2014 12:00:00 AM,42043,Central,South Central WDA,Dauphin,22,45 to 64 Years,Female,39957,3434,14980,7383,3927,6008,4225,10233,14160,40.4197464,-76.7796057
01/01/2011 12:00:00 AM,42043,Central,South Central WDA,Dauphin,22,45 to 64 Years,Female,39162,3308,15919,6800,3647,5378,4110,9488,13135,40.4197464,-76.7796057
01/01/2015 12:00:00 AM,42043,Central,South Central WDA,Dauphin,22,45 to 64 Years,Female,39890,3318,14629,7433,4110,6325,4075,10400,14510,40.4197464,-76.7796057
01/01/2016 12:00:00 AM,42043,Central,South Central WDA,Dauphin,22,45 to 64 Years,Female,39605,3205,13881,7240,4253,6992,4034,11026,15279,40.4197464,-76.7796057
01/01/2010 12:00:00 AM,42043,Central,South Central WDA,Dauphin,22,45 to 64 Years,Female,38425,3430,15370,6321,3779,5565,3960,9525,13304,40.4197464,-76.7796057
01/01/2014 12:00:00 AM,42043,Central,South Central WDA,Dauphin,22,25 to 34 Years,Female,18366,1583,4225,3662,1935,4614,2347,6961,8896,40.4197464,-76.7796057
01/01/2013 12:00:00 AM,42043,Central,South Central WDA,Dauphin,22,25 to 34 Years,Female,18158,1295,4104,3560,2006,4852,2341,7193,9199,40.4197464,-76.7796057
01/01/2015 12:00:00 AM,42043,Central,South Central WDA,Dauphin,22,25 to 34 Years,Female,18499,1683,4208,3429,1890,4951,2338,7289,9179,40.4197464,-76.7796057
01/01/2016 12:00:00 AM,42043,Central,South Central WDA,Dauphin,22,35 to 44 Years,Female,16735,1344,4848,2986,1999,3267,2291,5558,7557,40.4197464,-76.7796057
01/01/2016 12:00:00 AM,42043,Central,South Central WDA,Dauphin,22,25 to 34 Years,Female,18671,1713,4300,3440,1779,5154,2285,7439,9218,40.4197464,-76.7796057
01/01/2012 12:00:00 AM,42043,Central,South Central WDA,Dauphin,22,25 to 34 Years,Female,17859,1256,4251,3523,1830,4783,2216,6999,8829,40.4197464,-76.7796057
01/01/2014 12:00:00 AM,42043,Central,South Central WDA,Dauphin,22,35 to 44 Years,Female,16933,1113,4915,3346,1987,3422,2150,5572,7559,40.4197464,-76.7796057
01/01/2015 12:00:00 AM,42043,Central,South Central WDA,Dauphin,22,35 to 44 Years,Female,16875,1292,4852,3290,2076,3272,2093,5365,7441,40.4197464,-76.7796057
01/01/2013 12:00:00 AM,42043,Central,South Central WDA,Dauphin,22,35 to 44 Years,Female,17144,1115,5198,3251,1804,3691,2085,5776,7580,40.4197464,-76.7796057
01/01/2010 12:00:00 AM,42043,Central,South Central WDA,Dauphin,22,35 to 44 Years,Female,18381,1330,6118,3371,2050,3501,2011,5512,7562,40.4197464,-76.7796057
01/01/2011 12:00:00 AM,42043,Central,South Central WDA,Dauphin,22,25 to 34 Years,Female,17572,1307,4384,3485,1776,4667,1953,6620,8396,40.4197464,-76.7796057
01/01/2011 12:00:00 AM,42043,Central,South Central WDA,Dauphin,22,35 to 44 Years,Female,17945,1249,5521,3587,2059,3627,1902,5529,7588,40.4197464,-76.7796057
01/01/2010 12:00:00 AM,42043,Central,South Central WDA,Dauphin,22,35 to 44 Years,Male,17721,1833,6415,3199,1121,3257,1896,5153,6274,40.4197464,-76.7796057
01/01/2012 12:00:00 AM,42043,Central,South Central WDA,Dauphin,22,35 to 44 Years,Male,17043,1667,5671,3176,1323,3324,1882,5206,6529,40.4197464,-76.7796057
01/01/2011 12:00:00 AM,42043,Central,South Central WDA,Dauphin,22,35 to 44 Years,Male,17416,1733,6118,3115,1287,3292,1871,5163,6450,40.4197464,-76.7796057
01/01/2016 12:00:00 AM,42043,Central,South Central WDA,Dauphin,22,35 to 44 Years,Male,16147,1537,4723,2983,1586,3454,1864,5318,6904,40.4197464,-76.7796057
01/01/2016 12:00:00 AM,42043,Central,South Central WDA,Dauphin,22,25 to 34 Years,Male,18294,2153,5431,3488,1438,3935,1849,5784,7222,40.4197464,-76.7796057
01/01/2015 12:00:00 AM,42043,Central,South Central WDA,Dauphin,22,25 to 34 Years,Male,17983,1946,5282,3480,1485,3955,1835,5790,7275,40.4197464,-76.7796057
01/01/2012 12:00:00 AM,42043,Central,South Central WDA,Dauphin,22,35 to 44 Years,Female,17503,1118,5359,3504,2034,3665,1823,5488,7522,40.4197464,-76.7796057
01/01/2013 12:00:00 AM,42043,Central,South Central WDA,Dauphin,22,35 to 44 Years,Male,16772,1687,5310,3135,1373,3448,1819,5267,6640,40.4197464,-76.7796057
01/01/2014 12:00:00 AM,42043,Central,South Central WDA,Dauphin,22,25 to 34 Years,Male,17718,1886,5273,3523,1435,3795,1806,5601,7036,40.4197464,-76.7796057
01/01/2013 12:00:00 AM,42043,Central,South Central WDA,Dauphin,22,25 to 34 Years,Male,17455,1812,5081,3499,1326,3958,1779,5737,7063,40.4197464,-76.7796057
01/01/2010 12:00:00 AM,42043,Central,South Central WDA,Dauphin,22,25 to 34 Years,Female,17287,1270,4405,3365,1815,4687,1745,6432,8247,40.4197464,-76.7796057
01/01/2014 12:00:00 AM,42043,Central,South Central WDA,Dauphin,22,35 to 44 Years,Male,16531,1557,5180,2967,1512,3622,1693,5315,6827,40.4197464,-76.7796057
01/01/2015 12:00:00 AM,42043,Central,South Central WDA,Dauphin,22,35 to 44 Years,Male,16351,1555,4987,2944,1539,3646,1680,5326,6865,40.4197464,-76.7796057
01/01/2011 12:00:00 AM,42043,Central,South Central WDA,Dauphin,22,25 to 34 Years,Male,16809,1663,4974,3728,1251,3590,1603,5193,6444,40.4197464,-76.7796057
01/01/2012 12:00:00 AM,42043,Central,South Central WDA,Dauphin,22,25 to 34 Years,Male,17139,1748,5143,3442,1407,3804,1595,5399,6806,40.4197464,-76.7796057
01/01/2010 12:00:00 AM,42043,Central,South Central WDA,Dauphin,22,25 to 34 Years,Male,16551,1633,5183,3729,1155,3450,1401,4851,6006,40.4197464,-76.7796057
01/01/2016 12:00:00 AM,42011,Lehigh Valley,Berks County WDA,Berks,6,45 to 64 Years,Female,57621,5651,22742,9556,5060,8859,5753,14612,19672,40.4193964,-75.9307733
01/01/2015 12:00:00 AM,42011,Lehigh Valley,Berks County WDA,Berks,6,45 to 64 Years,Female,57697,5852,23300,9302,5162,8606,5475,14081,19243,40.4193964,-75.9307733
01/01/2014 12:00:00 AM,42011,Lehigh Valley,Berks County WDA,Berks,6,45 to 64 Years,Female,57534,6368,23326,9465,4557,8440,5378,13818,18375,40.4193964,-75.9307733
01/01/2013 12:00:00 AM,42011,Lehigh Valley,Berks County WDA,Berks,6,45 to 64 Years,Female,57206,6327,23383,9767,4448,7960,5321,13281,17729,40.4193964,-75.9307733
01/01/2012 12:00:00 AM,42011,Lehigh Valley,Berks County WDA,Berks,6,45 to 64 Years,Female,56576,5978,23384,10102,4069,7894,5149,13043,17112,40.4193964,-75.9307733
01/01/2011 12:00:00 AM,42011,Lehigh Valley,Berks County WDA,Berks,6,45 to 64 Years,Female,55743,6071,23321,9445,4075,7908,4923,12831,16906,40.4193964,-75.9307733
01/01/2010 12:00:00 AM,42011,Lehigh Valley,Berks County WDA,Berks,6,45 to 64 Years,Female,54615,6313,23251,8768,3728,7809,4746,12555,16283,40.4193964,-75.9307733
01/01/2010 12:00:00 AM,42011,Lehigh Valley,Berks County WDA,Berks,6,45 to 64 Years,Male,53656,7408,21811,8532,3570,7621,4714,12335,15905,40.4193964,-75.9307733
01/01/2016 12:00:00 AM,42011,Lehigh Valley,Berks County WDA,Berks,6,45 to 64 Years,Male,56474,7400,23558,8388,3856,8642,4630,13272,17128,40.4193964,-75.9307733
01/01/2011 12:00:00 AM,42011,Lehigh Valley,Berks County WDA,Berks,6,45 to 64 Years,Male,54759,7338,22690,8847,3466,7820,4598,12418,15884,40.4193964,-75.9307733
01/01/2014 12:00:00 AM,42011,Lehigh Valley,Berks County WDA,Berks,6,45 to 64 Years,Male,56572,7261,24121,8622,3842,8228,4498,12726,16568,40.4193964,-75.9307733
01/01/2012 12:00:00 AM,42011,Lehigh Valley,Berks County WDA,Berks,6,45 to 64 Years,Male,55511,7255,23361,8768,3453,8213,4461,12674,16127,40.4193964,-75.9307733
01/01/2015 12:00:00 AM,42011,Lehigh Valley,Berks County WDA,Berks,6,45 to 64 Years,Male,56687,7506,24355,8444,3611,8397,4374,12771,16382,40.4193964,-75.9307733
01/01/2013 12:00:00 AM,42011,Lehigh Valley,Berks County WDA,Berks,6,45 to 64 Years,Male,56190,7278,23853,8696,3756,8309,4298,12607,16363,40.4193964,-75.9307733
01/01/2016 12:00:00 AM,42011,Lehigh Valley,Berks County WDA,Berks,6,35 to 44 Years,Female,25041,3108,6420,4354,3208,5103,2848,7951,11159,40.4193964,-75.9307733
01/01/2015 12:00:00 AM,42011,Lehigh Valley,Berks County WDA,Berks,6,35 to 44 Years,Female,25516,2901,6958,4520,3175,5415,2547,7962,11137,40.4193964,-75.9307733
01/01/2014 12:00:00 AM,42011,Lehigh Valley,Berks County WDA,Berks,6,35 to 44 Years,Female,26028,3042,7478,4585,3167,5320,2436,7756,10923,40.4193964,-75.9307733
01/01/2013 12:00:00 AM,42011,Lehigh Valley,Berks County WDA,Berks,6,35 to 44 Years,Female,26675,2895,8292,4751,3196,5121,2420,7541,10737,40.4193964,-75.9307733
01/01/2016 12:00:00 AM,42011,Lehigh Valley,Berks County WDA,Berks,6,25 to 34 Years,Female,24543,2859,6086,5555,2631,5039,2373,7412,10043,40.4193964,-75.9307733
01/01/2012 12:00:00 AM,42011,Lehigh Valley,Berks County WDA,Berks,6,35 to 44 Years,Female,27420,2965,8730,5117,3120,5146,2342,7488,10608,40.4193964,-75.9307733
01/01/2015 12:00:00 AM,42011,Lehigh Valley,Berks County WDA,Berks,6,25 to 34 Years,Female,24309,2924,6087,5315,2613,5054,2316,7370,9983,40.4193964,-75.9307733
01/01/2014 12:00:00 AM,42011,Lehigh Valley,Berks County WDA,Berks,6,25 to 34 Years,Female,23908,2988,6372,4918,2268,5134,2228,7362,9630,40.4193964,-75.9307733
01/01/2011 12:00:00 AM,42011,Lehigh Valley,Berks County WDA,Berks,6,35 to 44 Years,Female,28115,3019,9248,5365,3056,5208,2219,7427,10483,40.4193964,-75.9307733
01/01/2013 12:00:00 AM,42011,Lehigh Valley,Berks County WDA,Berks,6,25 to 34 Years,Female,23557,2808,6303,4790,2347,5150,2159,7309,9656,40.4193964,-75.9307733
01/01/2012 12:00:00 AM,42011,Lehigh Valley,Berks County WDA,Berks,6,25 to 34 Years,Female,23305,2836,5542,5035,2351,5436,2105,7541,9892,40.4193964,-75.9307733
01/01/2016 12:00:00 AM,42011,Lehigh Valley,Berks County WDA,Berks,6,35 to 44 Years,Male,24224,3569,8466,3756,2249,4081,2103,6184,8433,40.4193964,-75.9307733
01/01/2011 12:00:00 AM,42011,Lehigh Valley,Berks County WDA,Berks,6,25 to 34 Years,Female,23174,2849,5784,4675,2364,5425,2077,7502,9866,40.4193964,-75.9307733
01/01/2010 12:00:00 AM,42011,Lehigh Valley,Berks County WDA,Berks,6,35 to 44 Years,Female,28772,3080,9933,5629,3106,4954,2070,7024,10130,40.4193964,-75.9307733
01/01/2015 12:00:00 AM,42011,Lehigh Valley,Berks County WDA,Berks,6,35 to 44 Years,Male,24745,3780,8511,3980,2224,4180,2070,6250,8474,40.4193964,-75.9307733
01/01/2013 12:00:00 AM,42011,Lehigh Valley,Berks County WDA,Berks,6,35 to 44 Years,Male,25735,3994,9295,4075,1903,4455,2013,6468,8371,40.4193964,-75.9307733
01/01/2014 12:00:00 AM,42011,Lehigh Valley,Berks County WDA,Berks,6,35 to 44 Years,Male,25188,3913,8871,4161,2053,4183,2007,6190,8243,40.4193964,-75.9307733
01/01/2012 12:00:00 AM,42011,Lehigh Valley,Berks County WDA,Berks,6,35 to 44 Years,Male,26527,3926,9755,4210,2140,4499,1997,6496,8636,40.4193964,-75.9307733
01/01/2010 12:00:00 AM,42011,Lehigh Valley,Berks County WDA,Berks,6,35 to 44 Years,Male,28081,3884,11206,4323,2213,4514,1941,6455,8668,40.4193964,-75.9307733
01/01/2011 12:00:00 AM,42011,Lehigh Valley,Berks County WDA,Berks,6,35 to 44 Years,Male,27340,3860,10505,4364,2117,4641,1853,6494,8611,40.4193964,-75.9307733
01/01/2010 12:00:00 AM,42011,Lehigh Valley,Berks County WDA,Berks,6,25 to 34 Years,Female,23123,2821,6024,4718,2250,5491,1819,7310,9560,40.4193964,-75.9307733
01/01/2016 12:00:00 AM,42011,Lehigh Valley,Berks County WDA,Berks,6,25 to 34 Years,Male,24553,3107,8994,4581,2302,4399,1170,5569,7871,40.4193964,-75.9307733
01/01/2015 12:00:00 AM,42011,Lehigh Valley,Berks County WDA,Berks,6,25 to 34 Years,Male,24043,3189,8323,4475,2407,4508,1141,5649,8056,40.4193964,-75.9307733
01/01/2013 12:00:00 AM,42011,Lehigh Valley,Berks County WDA,Berks,6,25 to 34 Years,Male,23305,3559,8459,4237,2151,3801,1098,4899,7050,40.4193964,-75.9307733
01/01/2014 12:00:00 AM,42011,Lehigh Valley,Berks County WDA,Berks,6,25 to 34 Years,Male,23704,3596,8410,4177,2243,4200,1078,5278,7521,40.4193964,-75.9307733
01/01/2010 12:00:00 AM,42011,Lehigh Valley,Berks County WDA,Berks,6,25 to 34 Years,Male,22764,3659,8331,4017,1752,4022,983,5005,6757,40.4193964,-75.9307733
01/01/2012 12:00:00 AM,42011,Lehigh Valley,Berks County WDA,Berks,6,25 to 34 Years,Male,23011,3678,8039,4230,2040,4080,944,5024,7064,40.4193964,-75.9307733
01/01/2011 12:00:00 AM,42011,Lehigh Valley,Berks County WDA,Berks,6,25 to 34 Years,Male,22839,3517,8067,4296,2009,4095,855,4950,6959,40.4193964,-75.9307733
01/01/2012 12:00:00 AM,42061,Central,Southern Alleghenies WDA,Huntingdon,31,45 to 64 Years,Male,6999,690,3836,1035,415,563,460,1023,1438,40.416105,-77.9827661
01/01/2010 12:00:00 AM,42061,Central,Southern Alleghenies WDA,Huntingdon,31,45 to 64 Years,Male,6828,844,3605,938,356,665,420,1085,1441,40.416105,-77.9827661
01/01/2014 12:00:00 AM,42061,Central,Southern Alleghenies WDA,Huntingdon,31,45 to 64 Years,Female,6232,422,3330,1072,497,491,420,911,1408,40.416105,-77.9827661
01/01/2015 12:00:00 AM,42061,Central,Southern Alleghenies WDA,Huntingdon,31,45 to 64 Years,Female,6092,336,3263,1006,572,512,403,915,1487,40.416105,-77.9827661
01/01/2016 12:00:00 AM,42061,Central,Southern Alleghenies WDA,Huntingdon,31,45 to 64 Years,Female,5981,341,3127,977,574,563,399,962,1536,40.416105,-77.9827661
01/01/2011 12:00:00 AM,42061,Central,Southern Alleghenies WDA,Huntingdon,31,45 to 64 Years,Male,6926,760,3737,994,425,612,398,1010,1435,40.416105,-77.9827661
01/01/2012 12:00:00 AM,42061,Central,Southern Alleghenies WDA,Huntingdon,31,45 to 64 Years,Female,6185,445,3331,1042,469,513,385,898,1367,40.416105,-77.9827661
01/01/2013 12:00:00 AM,42061,Central,Southern Alleghenies WDA,Huntingdon,31,45 to 64 Years,Female,6162,410,3308,1015,508,538,383,921,1429,40.416105,-77.9827661
01/01/2011 12:00:00 AM,42061,Central,Southern Alleghenies WDA,Huntingdon,31,45 to 64 Years,Female,6081,490,3360,890,424,552,365,917,1341,40.416105,-77.9827661
01/01/2013 12:00:00 AM,42061,Central,Southern Alleghenies WDA,Huntingdon,31,45 to 64 Years,Male,6999,689,3943,1088,420,501,358,859,1279,40.416105,-77.9827661
01/01/2014 12:00:00 AM,42061,Central,Southern Alleghenies WDA,Huntingdon,31,45 to 64 Years,Male,6958,650,3938,1071,424,520,355,875,1299,40.416105,-77.9827661
01/01/2010 12:00:00 AM,42061,Central,Southern Alleghenies WDA,Huntingdon,31,45 to 64 Years,Female,6040,522,3303,860,434,585,336,921,1355,40.416105,-77.9827661
01/01/2015 12:00:00 AM,42061,Central,Southern Alleghenies WDA,Huntingdon,31,45 to 64 Years,Male,6958,664,3987,1052,458,471,326,797,1255,40.416105,-77.9827661
01/01/2016 12:00:00 AM,42061,Central,Southern Alleghenies WDA,Huntingdon,31,45 to 64 Years,Male,6911,688,3930,1066,469,467,291,758,1227,40.416105,-77.9827661
01/01/2014 12:00:00 AM,42061,Central,Southern Alleghenies WDA,Huntingdon,31,35 to 44 Years,Female,2446,156,904,408,338,419,221,640,978,40.416105,-77.9827661
01/01/2015 12:00:00 AM,42061,Central,Southern Alleghenies WDA,Huntingdon,31,35 to 44 Years,Female,2431,144,826,426,358,467,210,677,1035,40.416105,-77.9827661
01/01/2016 12:00:00 AM,42061,Central,Southern Alleghenies WDA,Huntingdon,31,35 to 44 Years,Female,2387,115,825,435,350,458,204,662,1012,40.416105,-77.9827661
01/01/2013 12:00:00 AM,42061,Central,Southern Alleghenies WDA,Huntingdon,31,35 to 44 Years,Female,2513,132,1027,453,321,376,204,580,901,40.416105,-77.9827661
01/01/2012 12:00:00 AM,42061,Central,Southern Alleghenies WDA,Huntingdon,31,35 to 44 Years,Female,2605,181,1168,447,313,328,168,496,809,40.416105,-77.9827661
01/01/2010 12:00:00 AM,42061,Central,Southern Alleghenies WDA,Huntingdon,31,35 to 44 Years,Male,3644,432,2001,499,177,373,162,535,712,40.416105,-77.9827661
01/01/2011 12:00:00 AM,42061,Central,Southern Alleghenies WDA,Huntingdon,31,35 to 44 Years,Male,3665,374,2127,435,197,387,145,532,729,40.416105,-77.9827661
01/01/2014 12:00:00 AM,42061,Central,Southern Alleghenies WDA,Huntingdon,31,35 to 44 Years,Male,3363,392,1909,441,141,336,144,480,621,40.416105,-77.9827661
01/01/2011 12:00:00 AM,42061,Central,Southern Alleghenies WDA,Huntingdon,31,35 to 44 Years,Female,2656,181,1238,475,265,355,142,497,762,40.416105,-77.9827661
01/01/2011 12:00:00 AM,42061,Central,Southern Alleghenies WDA,Huntingdon,31,25 to 34 Years,Female,2107,120,688,386,449,323,141,464,913,40.416105,-77.9827661
01/01/2010 12:00:00 AM,42061,Central,Southern Alleghenies WDA,Huntingdon,31,25 to 34 Years,Male,3510,583,1858,463,291,182,133,315,606,40.416105,-77.9827661
01/01/2010 12:00:00 AM,42061,Central,Southern Alleghenies WDA,Huntingdon,31,25 to 34 Years,Female,2130,103,806,371,346,374,130,504,850,40.416105,-77.9827661
01/01/2012 12:00:00 AM,42061,Central,Southern Alleghenies WDA,Huntingdon,31,35 to 44 Years,Male,3556,399,2016,469,164,387,121,508,672,40.416105,-77.9827661
01/01/2013 12:00:00 AM,42061,Central,Southern Alleghenies WDA,Huntingdon,31,35 to 44 Years,Male,3480,434,1941,461,151,376,117,493,644,40.416105,-77.9827661
01/01/2010 12:00:00 AM,42061,Central,Southern Alleghenies WDA,Huntingdon,31,35 to 44 Years,Female,2703,162,1387,431,297,309,117,426,723,40.416105,-77.9827661
01/01/2011 12:00:00 AM,42061,Central,Southern Alleghenies WDA,Huntingdon,31,25 to 34 Years,Male,3418,469,1741,639,264,194,111,305,569,40.416105,-77.9827661
01/01/2012 12:00:00 AM,42061,Central,Southern Alleghenies WDA,Huntingdon,31,25 to 34 Years,Male,3409,496,1798,586,266,155,108,263,529,40.416105,-77.9827661
01/01/2012 12:00:00 AM,42061,Central,Southern Alleghenies WDA,Huntingdon,31,25 to 34 Years,Female,2132,116,776,385,421,327,107,434,855,40.416105,-77.9827661
01/01/2013 12:00:00 AM,42061,Central,Southern Alleghenies WDA,Huntingdon,31,25 to 34 Years,Female,2131,115,769,444,398,299,106,405,803,40.416105,-77.9827661
01/01/2016 12:00:00 AM,42061,Central,Southern Alleghenies WDA,Huntingdon,31,35 to 44 Years,Male,3293,359,1878,556,158,239,103,342,500,40.416105,-77.9827661
01/01/2015 12:00:00 AM,42061,Central,Southern Alleghenies WDA,Huntingdon,31,35 to 44 Years,Male,3377,316,2024,497,157,281,102,383,540,40.416105,-77.9827661
01/01/2014 12:00:00 AM,42061,Central,Southern Alleghenies WDA,Huntingdon,31,25 to 34 Years,Female,2155,145,770,398,391,351,100,451,842,40.416105,-77.9827661
01/01/2016 12:00:00 AM,42061,Central,Southern Alleghenies WDA,Huntingdon,31,25 to 34 Years,Female,2228,145,864,385,330,412,92,504,834,40.416105,-77.9827661
01/01/2015 12:00:00 AM,42061,Central,Southern Alleghenies WDA,Huntingdon,31,25 to 34 Years,Female,2188,147,797,416,382,371,75,446,828,40.416105,-77.9827661
01/01/2016 12:00:00 AM,42061,Central,Southern Alleghenies WDA,Huntingdon,31,25 to 34 Years,Male,3387,403,1808,594,242,267,73,340,582,40.416105,-77.9827661
01/01/2013 12:00:00 AM,42061,Central,Southern Alleghenies WDA,Huntingdon,31,25 to 34 Years,Male,3386,426,1836,594,267,192,71,263,530,40.416105,-77.9827661
01/01/2015 12:00:00 AM,42061,Central,Southern Alleghenies WDA,Huntingdon,31,25 to 34 Years,Male,3352,398,1734,638,276,238,68,306,582,40.416105,-77.9827661
01/01/2014 12:00:00 AM,42061,Central,Southern Alleghenies WDA,Huntingdon,31,25 to 34 Years,Male,3415,500,1705,622,310,212,66,278,588,40.416105,-77.9827661
01/01/2013 12:00:00 AM,42099,Central,South Central WDA,Perry,50,45 to 64 Years,Female,6964,655,3364,1244,576,639,486,1125,1701,40.4041532,-77.2590738
01/01/2014 12:00:00 AM,42099,Central,South Central WDA,Perry,50,45 to 64 Years,Female,6963,614,3332,1212,649,710,446,1156,1805,40.4041532,-77.2590738
01/01/2012 12:00:00 AM,42099,Central,South Central WDA,Perry,50,45 to 64 Years,Female,6875,702,3401,1232,576,526,438,964,1540,40.4041532,-77.2590738
01/01/2016 12:00:00 AM,42099,Central,South Central WDA,Perry,50,45 to 64 Years,Female,6942,580,3467,1132,564,772,427,1199,1763,40.4041532,-77.2590738
01/01/2015 12:00:00 AM,42099,Central,South Central WDA,Perry,50,45 to 64 Years,Female,6964,556,3457,1207,627,708,409,1117,1744,40.4041532,-77.2590738
01/01/2011 12:00:00 AM,42099,Central,South Central WDA,Perry,50,45 to 64 Years,Female,6842,764,3558,1066,547,504,403,907,1454,40.4041532,-77.2590738
01/01/2010 12:00:00 AM,42099,Central,South Central WDA,Perry,50,45 to 64 Years,Female,6706,710,3608,1004,483,502,399,901,1384,40.4041532,-77.2590738
01/01/2010 12:00:00 AM,42099,Central,South Central WDA,Perry,50,45 to 64 Years,Male,6962,1029,3627,944,401,655,306,961,1362,40.4041532,-77.2590738
01/01/2011 12:00:00 AM,42099,Central,South Central WDA,Perry,50,45 to 64 Years,Male,7070,1017,3586,1040,468,676,283,959,1427,40.4041532,-77.2590738
01/01/2015 12:00:00 AM,42099,Central,South Central WDA,Perry,50,45 to 64 Years,Male,7089,802,3612,1091,571,749,264,1013,1584,40.4041532,-77.2590738
01/01/2013 12:00:00 AM,42099,Central,South Central WDA,Perry,50,25 to 34 Years,Female,2457,263,832,407,312,381,262,643,955,40.4041532,-77.2590738
01/01/2012 12:00:00 AM,42099,Central,South Central WDA,Perry,50,45 to 64 Years,Male,7075,1018,3537,1056,538,666,260,926,1464,40.4041532,-77.2590738
01/01/2016 12:00:00 AM,42099,Central,South Central WDA,Perry,50,45 to 64 Years,Male,7050,892,3518,1046,546,790,258,1048,1594,40.4041532,-77.2590738
01/01/2015 12:00:00 AM,42099,Central,South Central WDA,Perry,50,25 to 34 Years,Female,2517,205,679,527,432,416,258,674,1106,40.4041532,-77.2590738
01/01/2014 12:00:00 AM,42099,Central,South Central WDA,Perry,50,25 to 34 Years,Female,2509,225,722,520,362,429,251,680,1042,40.4041532,-77.2590738
01/01/2014 12:00:00 AM,42099,Central,South Central WDA,Perry,50,45 to 64 Years,Male,7125,988,3481,1091,588,729,248,977,1565,40.4041532,-77.2590738
01/01/2013 12:00:00 AM,42099,Central,South Central WDA,Perry,50,35 to 44 Years,Male,3067,357,1407,448,235,376,244,620,855,40.4041532,-77.2590738
01/01/2013 12:00:00 AM,42099,Central,South Central WDA,Perry,50,45 to 64 Years,Male,7143,972,3529,1092,546,769,235,1004,1550,40.4041532,-77.2590738
01/01/2012 12:00:00 AM,42099,Central,South Central WDA,Perry,50,35 to 44 Years,Male,3193,373,1457,466,228,445,224,669,897,40.4041532,-77.2590738
01/01/2012 12:00:00 AM,42099,Central,South Central WDA,Perry,50,25 to 34 Years,Female,2471,250,847,455,289,410,220,630,919,40.4041532,-77.2590738
01/01/2016 12:00:00 AM,42099,Central,South Central WDA,Perry,50,25 to 34 Years,Female,2559,187,762,559,427,408,216,624,1051,40.4041532,-77.2590738
01/01/2014 12:00:00 AM,42099,Central,South Central WDA,Perry,50,35 to 44 Years,Male,2971,270,1396,403,309,377,216,593,902,40.4041532,-77.2590738
01/01/2015 12:00:00 AM,42099,Central,South Central WDA,Perry,50,35 to 44 Years,Male,2899,276,1284,476,325,334,204,538,863,40.4041532,-77.2590738
01/01/2011 12:00:00 AM,42099,Central,South Central WDA,Perry,50,25 to 34 Years,Female,2485,227,938,404,266,449,201,650,916,40.4041532,-77.2590738
01/01/2016 12:00:00 AM,42099,Central,South Central WDA,Perry,50,35 to 44 Years,Female,2815,132,958,732,349,443,201,644,993,40.4041532,-77.2590738
01/01/2015 12:00:00 AM,42099,Central,South Central WDA,Perry,50,35 to 44 Years,Female,2913,120,1014,851,331,397,200,597,928,40.4041532,-77.2590738
01/01/2016 12:00:00 AM,42099,Central,South Central WDA,Perry,50,35 to 44 Years,Male,2824,303,1233,493,280,325,190,515,795,40.4041532,-77.2590738
01/01/2012 12:00:00 AM,42099,Central,South Central WDA,Perry,50,35 to 44 Years,Female,3197,253,1225,736,293,501,189,690,983,40.4041532,-77.2590738
01/01/2014 12:00:00 AM,42099,Central,South Central WDA,Perry,50,35 to 44 Years,Female,3020,136,1060,834,328,473,189,662,990,40.4041532,-77.2590738
01/01/2013 12:00:00 AM,42099,Central,South Central WDA,Perry,50,35 to 44 Years,Female,3092,169,1193,781,328,444,177,621,949,40.4041532,-77.2590738
01/01/2011 12:00:00 AM,42099,Central,South Central WDA,Perry,50,35 to 44 Years,Female,3241,260,1449,658,267,437,170,607,874,40.4041532,-77.2590738
01/01/2010 12:00:00 AM,42099,Central,South Central WDA,Perry,50,35 to 44 Years,Female,3291,250,1523,613,312,425,168,593,905,40.4041532,-77.2590738
01/01/2010 12:00:00 AM,42099,Central,South Central WDA,Perry,50,25 to 34 Years,Female,2501,219,1066,410,272,383,151,534,806,40.4041532,-77.2590738
01/01/2011 12:00:00 AM,42099,Central,South Central WDA,Perry,50,35 to 44 Years,Male,3294,408,1596,471,218,471,130,601,819,40.4041532,-77.2590738
01/01/2010 12:00:00 AM,42099,Central,South Central WDA,Perry,50,35 to 44 Years,Male,3374,397,1679,549,185,461,103,564,749,40.4041532,-77.2590738
01/01/2014 12:00:00 AM,42099,Central,South Central WDA,Perry,50,25 to 34 Years,Male,2559,273,1040,516,301,357,72,429,730,40.4041532,-77.2590738
01/01/2013 12:00:00 AM,42099,Central,South Central WDA,Perry,50,25 to 34 Years,Male,2550,381,1102,451,246,306,64,370,616,40.4041532,-77.2590738
01/01/2016 12:00:00 AM,42099,Central,South Central WDA,Perry,50,25 to 34 Years,Male,2585,281,1089,551,289,321,54,375,664,40.4041532,-77.2590738
01/01/2015 12:00:00 AM,42099,Central,South Central WDA,Perry,50,25 to 34 Years,Male,2572,257,1056,542,294,377,46,423,717,40.4041532,-77.2590738
01/01/2012 12:00:00 AM,42099,Central,South Central WDA,Perry,50,25 to 34 Years,Male,2530,394,1082,449,256,311,38,349,605,40.4041532,-77.2590738
01/01/2010 12:00:00 AM,42099,Central,South Central WDA,Perry,50,25 to 34 Years,Male,2489,392,1119,414,218,312,34,346,564,40.4041532,-77.2590738
01/01/2011 12:00:00 AM,42099,Central,South Central WDA,Perry,50,25 to 34 Years,Male,2541,347,1123,438,232,368,33,401,633,40.4041532,-77.2590738
01/01/2013 12:00:00 AM,42075,Lehigh Valley,South Central WDA,Lebanon,38,45 to 64 Years,Male,18229,2077,8788,2360,1268,2159,1577,3736,5004,40.367597,-76.4618257
01/01/2011 12:00:00 AM,42075,Lehigh Valley,South Central WDA,Lebanon,38,45 to 64 Years,Male,17881,2175,8568,2268,1213,2088,1569,3657,4870,40.367597,-76.4618257
01/01/2012 12:00:00 AM,42075,Lehigh Valley,South Central WDA,Lebanon,38,45 to 64 Years,Male,18081,2087,8712,2262,1364,2139,1517,3656,5020,40.367597,-76.4618257
01/01/2016 12:00:00 AM,42075,Lehigh Valley,South Central WDA,Lebanon,38,45 to 64 Years,Female,18788,1834,8693,2861,1519,2408,1473,3881,5400,40.367597,-76.4618257
01/01/2015 12:00:00 AM,42075,Lehigh Valley,South Central WDA,Lebanon,38,45 to 64 Years,Female,18816,1859,8877,2783,1455,2379,1463,3842,5297,40.367597,-76.4618257
01/01/2014 12:00:00 AM,42075,Lehigh Valley,South Central WDA,Lebanon,38,45 to 64 Years,Male,18264,2077,8764,2360,1314,2287,1462,3749,5063,40.367597,-76.4618257
01/01/2015 12:00:00 AM,42075,Lehigh Valley,South Central WDA,Lebanon,38,45 to 64 Years,Male,18271,2188,8823,2437,1217,2165,1441,3606,4823,40.367597,-76.4618257
01/01/2010 12:00:00 AM,42075,Lehigh Valley,South Central WDA,Lebanon,38,45 to 64 Years,Male,17575,2294,8339,2535,1118,1890,1399,3289,4407,40.367597,-76.4618257
01/01/2014 12:00:00 AM,42075,Lehigh Valley,South Central WDA,Lebanon,38,45 to 64 Years,Female,18796,1822,9029,2753,1393,2459,1340,3799,5192,40.367597,-76.4618257
01/01/2016 12:00:00 AM,42075,Lehigh Valley,South Central WDA,Lebanon,38,45 to 64 Years,Male,18113,2220,8721,2529,1113,2234,1296,3530,4643,40.367597,-76.4618257
01/01/2013 12:00:00 AM,42075,Lehigh Valley,South Central WDA,Lebanon,38,45 to 64 Years,Female,18770,1990,9105,2794,1233,2403,1245,3648,4881,40.367597,-76.4618257
01/01/2012 12:00:00 AM,42075,Lehigh Valley,South Central WDA,Lebanon,38,45 to 64 Years,Female,18638,2054,9038,2850,1295,2301,1100,3401,4696,40.367597,-76.4618257
01/01/2010 12:00:00 AM,42075,Lehigh Valley,South Central WDA,Lebanon,38,45 to 64 Years,Female,18208,2299,9071,2513,1111,2115,1099,3214,4325,40.367597,-76.4618257
01/01/2011 12:00:00 AM,42075,Lehigh Valley,South Central WDA,Lebanon,38,45 to 64 Years,Female,18557,2375,9021,2612,1211,2296,1042,3338,4549,40.367597,-76.4618257
01/01/2012 12:00:00 AM,42075,Lehigh Valley,South Central WDA,Lebanon,38,35 to 44 Years,Female,8487,635,3200,1575,757,1390,930,2320,3077,40.367597,-76.4618257
01/01/2016 12:00:00 AM,42075,Lehigh Valley,South Central WDA,Lebanon,38,35 to 44 Years,Female,8080,700,2534,1572,957,1411,906,2317,3274,40.367597,-76.4618257
01/01/2015 12:00:00 AM,42075,Lehigh Valley,South Central WDA,Lebanon,38,35 to 44 Years,Female,8087,731,2694,1438,969,1359,896,2255,3224,40.367597,-76.4618257
01/01/2014 12:00:00 AM,42075,Lehigh Valley,South Central WDA,Lebanon,38,35 to 44 Years,Female,8282,702,3076,1414,844,1358,888,2246,3090,40.367597,-76.4618257
01/01/2013 12:00:00 AM,42075,Lehigh Valley,South Central WDA,Lebanon,38,35 to 44 Years,Female,8393,600,3140,1500,819,1465,869,2334,3153,40.367597,-76.4618257
01/01/2011 12:00:00 AM,42075,Lehigh Valley,South Central WDA,Lebanon,38,35 to 44 Years,Female,8513,684,3331,1478,816,1426,778,2204,3020,40.367597,-76.4618257
01/01/2014 12:00:00 AM,42075,Lehigh Valley,South Central WDA,Lebanon,38,25 to 34 Years,Female,7693,849,2090,1835,790,1355,774,2129,2919,40.367597,-76.4618257
01/01/2016 12:00:00 AM,42075,Lehigh Valley,South Central WDA,Lebanon,38,25 to 34 Years,Female,7918,933,2238,1751,958,1285,753,2038,2996,40.367597,-76.4618257
01/01/2015 12:00:00 AM,42075,Lehigh Valley,South Central WDA,Lebanon,38,25 to 34 Years,Female,7827,786,2180,1925,987,1213,736,1949,2936,40.367597,-76.4618257
01/01/2012 12:00:00 AM,42075,Lehigh Valley,South Central WDA,Lebanon,38,25 to 34 Years,Female,7497,841,2078,1848,743,1305,682,1987,2730,40.367597,-76.4618257
01/01/2010 12:00:00 AM,42075,Lehigh Valley,South Central WDA,Lebanon,38,35 to 44 Years,Female,8687,769,3615,1494,676,1484,649,2133,2809,40.367597,-76.4618257
01/01/2013 12:00:00 AM,42075,Lehigh Valley,South Central WDA,Lebanon,38,25 to 34 Years,Female,7549,884,2207,1678,840,1313,627,1940,2780,40.367597,-76.4618257
01/01/2011 12:00:00 AM,42075,Lehigh Valley,South Central WDA,Lebanon,38,25 to 34 Years,Female,7438,796,2150,1708,772,1428,584,2012,2784,40.367597,-76.4618257
01/01/2010 12:00:00 AM,42075,Lehigh Valley,South Central WDA,Lebanon,38,25 to 34 Years,Female,7342,765,2250,1602,751,1456,518,1974,2725,40.367597,-76.4618257
01/01/2016 12:00:00 AM,42075,Lehigh Valley,South Central WDA,Lebanon,38,35 to 44 Years,Male,8121,1014,3147,1567,652,1260,481,1741,2393,40.367597,-76.4618257
01/01/2015 12:00:00 AM,42075,Lehigh Valley,South Central WDA,Lebanon,38,35 to 44 Years,Male,8164,1145,3383,1405,627,1146,458,1604,2231,40.367597,-76.4618257
01/01/2014 12:00:00 AM,42075,Lehigh Valley,South Central WDA,Lebanon,38,35 to 44 Years,Male,8247,1113,3449,1351,649,1250,435,1685,2334,40.367597,-76.4618257
01/01/2013 12:00:00 AM,42075,Lehigh Valley,South Central WDA,Lebanon,38,35 to 44 Years,Male,8354,1114,3639,1241,669,1283,408,1691,2360,40.367597,-76.4618257
01/01/2010 12:00:00 AM,42075,Lehigh Valley,South Central WDA,Lebanon,38,35 to 44 Years,Male,8846,1021,4331,1158,690,1251,395,1646,2336,40.367597,-76.4618257
01/01/2012 12:00:00 AM,42075,Lehigh Valley,South Central WDA,Lebanon,38,35 to 44 Years,Male,8539,1081,3859,1178,662,1377,382,1759,2421,40.367597,-76.4618257
01/01/2016 12:00:00 AM,42075,Lehigh Valley,South Central WDA,Lebanon,38,25 to 34 Years,Male,7719,1289,2717,1811,606,962,334,1296,1902,40.367597,-76.4618257
01/01/2013 12:00:00 AM,42075,Lehigh Valley,South Central WDA,Lebanon,38,25 to 34 Years,Male,7430,1165,2678,1625,618,1013,331,1344,1962,40.367597,-76.4618257
01/01/2014 12:00:00 AM,42075,Lehigh Valley,South Central WDA,Lebanon,38,25 to 34 Years,Male,7531,1385,2661,1549,618,999,319,1318,1936,40.367597,-76.4618257
01/01/2011 12:00:00 AM,42075,Lehigh Valley,South Central WDA,Lebanon,38,35 to 44 Years,Male,8720,1071,4153,1248,671,1264,313,1577,2248,40.367597,-76.4618257
01/01/2011 12:00:00 AM,42075,Lehigh Valley,South Central WDA,Lebanon,38,25 to 34 Years,Male,7389,926,3036,1374,687,1062,304,1366,2053,40.367597,-76.4618257
01/01/2012 12:00:00 AM,42075,Lehigh Valley,South Central WDA,Lebanon,38,25 to 34 Years,Male,7457,1147,2845,1453,646,1063,303,1366,2012,40.367597,-76.4618257
01/01/2010 12:00:00 AM,42075,Lehigh Valley,South Central WDA,Lebanon,38,25 to 34 Years,Male,7330,887,3011,1365,629,1144,294,1438,2067,40.367597,-76.4618257
01/01/2015 12:00:00 AM,42075,Lehigh Valley,South Central WDA,Lebanon,38,25 to 34 Years,Male,7624,1433,2809,1508,608,993,273,1266,1874,40.367597,-76.4618257
01/01/2016 12:00:00 AM,42017,Southeast,Bucks County WDA,Bucks,9,45 to 64 Years,Male,95585,4804,29886,16520,6536,22397,15442,37839,44375,40.3350113,-75.1129124
01/01/2016 12:00:00 AM,42017,Southeast,Bucks County WDA,Bucks,9,45 to 64 Years,Female,98992,3838,29370,16941,10424,23112,15307,38419,48843,40.3350113,-75.1129124
01/01/2014 12:00:00 AM,42017,Southeast,Bucks County WDA,Bucks,9,45 to 64 Years,Male,95871,4510,30442,17289,6763,21569,15298,36867,43630,40.3350113,-75.1129124
01/01/2011 12:00:00 AM,42017,Southeast,Bucks County WDA,Bucks,9,45 to 64 Years,Male,93273,4840,29040,17388,6409,20319,15277,35596,42005,40.3350113,-75.1129124
01/01/2013 12:00:00 AM,42017,Southeast,Bucks County WDA,Bucks,9,45 to 64 Years,Male,95369,4806,30176,17457,6458,21324,15148,36472,42930,40.3350113,-75.1129124
01/01/2012 12:00:00 AM,42017,Southeast,Bucks County WDA,Bucks,9,45 to 64 Years,Male,94532,4985,29884,17616,6290,20653,15104,35757,42047,40.3350113,-75.1129124
01/01/2015 12:00:00 AM,42017,Southeast,Bucks County WDA,Bucks,9,45 to 64 Years,Male,96000,4666,30800,16581,6734,22120,15099,37219,43953,40.3350113,-75.1129124
01/01/2015 12:00:00 AM,42017,Southeast,Bucks County WDA,Bucks,9,45 to 64 Years,Female,99233,3724,30301,17088,10117,22978,15025,38003,48120,40.3350113,-75.1129124
01/01/2010 12:00:00 AM,42017,Southeast,Bucks County WDA,Bucks,9,45 to 64 Years,Male,91603,4916,27358,17721,6308,20436,14864,35300,41608,40.3350113,-75.1129124
01/01/2014 12:00:00 AM,42017,Southeast,Bucks County WDA,Bucks,9,45 to 64 Years,Female,99066,3516,30948,17855,9816,22450,14481,36931,46747,40.3350113,-75.1129124
01/01/2013 12:00:00 AM,42017,Southeast,Bucks County WDA,Bucks,9,45 to 64 Years,Female,98575,3613,31843,17774,9731,21425,14189,35614,45345,40.3350113,-75.1129124
01/01/2012 12:00:00 AM,42017,Southeast,Bucks County WDA,Bucks,9,45 to 64 Years,Female,97531,4108,32206,17498,9729,20054,13936,33990,43719,40.3350113,-75.1129124
01/01/2011 12:00:00 AM,42017,Southeast,Bucks County WDA,Bucks,9,45 to 64 Years,Female,96245,4190,32187,17631,9663,18951,13623,32574,42237,40.3350113,-75.1129124
01/01/2010 12:00:00 AM,42017,Southeast,Bucks County WDA,Bucks,9,45 to 64 Years,Female,94277,4601,31466,17526,9490,17899,13295,31194,40684,40.3350113,-75.1129124
01/01/2016 12:00:00 AM,42017,Southeast,Bucks County WDA,Bucks,9,35 to 44 Years,Female,38001,1275,7574,6914,3050,11096,8092,19188,22238,40.3350113,-75.1129124
01/01/2015 12:00:00 AM,42017,Southeast,Bucks County WDA,Bucks,9,35 to 44 Years,Female,38923,1174,8046,7365,3315,11252,7771,19023,22338,40.3350113,-75.1129124
01/01/2014 12:00:00 AM,42017,Southeast,Bucks County WDA,Bucks,9,35 to 44 Years,Female,39966,1012,8885,7428,3507,11606,7528,19134,22641,40.3350113,-75.1129124
01/01/2012 12:00:00 AM,42017,Southeast,Bucks County WDA,Bucks,9,35 to 44 Years,Female,42812,1003,10316,8049,4278,11772,7394,19166,23444,40.3350113,-75.1129124
01/01/2013 12:00:00 AM,42017,Southeast,Bucks County WDA,Bucks,9,35 to 44 Years,Female,41244,1001,9472,7856,3994,11732,7189,18921,22915,40.3350113,-75.1129124
01/01/2011 12:00:00 AM,42017,Southeast,Bucks County WDA,Bucks,9,35 to 44 Years,Female,44353,1327,11422,8548,4499,11518,7039,18557,23056,40.3350113,-75.1129124
01/01/2010 12:00:00 AM,42017,Southeast,Bucks County WDA,Bucks,9,35 to 44 Years,Female,45993,1580,12331,8701,4348,12036,6997,19033,23381,40.3350113,-75.1129124
01/01/2010 12:00:00 AM,42017,Southeast,Bucks County WDA,Bucks,9,35 to 44 Years,Male,44108,2582,13042,8503,3082,10339,6560,16899,19981,40.3350113,-75.1129124
01/01/2011 12:00:00 AM,42017,Southeast,Bucks County WDA,Bucks,9,35 to 44 Years,Male,42583,2170,12580,8381,2830,10221,6401,16622,19452,40.3350113,-75.1129124
01/01/2013 12:00:00 AM,42017,Southeast,Bucks County WDA,Bucks,9,35 to 44 Years,Male,39616,1915,11991,7377,2479,9503,6351,15854,18333,40.3350113,-75.1129124
01/01/2012 12:00:00 AM,42017,Southeast,Bucks County WDA,Bucks,9,35 to 44 Years,Male,41075,1859,12539,7758,2764,9841,6314,16155,18919,40.3350113,-75.1129124
01/01/2015 12:00:00 AM,42017,Southeast,Bucks County WDA,Bucks,9,35 to 44 Years,Male,37560,2054,9806,7108,2730,9554,6308,15862,18592,40.3350113,-75.1129124
01/01/2014 12:00:00 AM,42017,Southeast,Bucks County WDA,Bucks,9,35 to 44 Years,Male,38464,2070,10958,7232,2531,9372,6301,15673,18204,40.3350113,-75.1129124
01/01/2016 12:00:00 AM,42017,Southeast,Bucks County WDA,Bucks,9,35 to 44 Years,Male,36788,2038,9660,6649,2686,9457,6298,15755,18441,40.3350113,-75.1129124
01/01/2016 12:00:00 AM,42017,Southeast,Bucks County WDA,Bucks,9,25 to 34 Years,Female,34058,1485,6212,6514,3634,10819,5394,16213,19847,40.3350113,-75.1129124
01/01/2015 12:00:00 AM,42017,Southeast,Bucks County WDA,Bucks,9,25 to 34 Years,Female,34094,1548,6605,6914,3589,10244,5194,15438,19027,40.3350113,-75.1129124
01/01/2014 12:00:00 AM,42017,Southeast,Bucks County WDA,Bucks,9,25 to 34 Years,Female,33895,1361,6819,7438,3428,10052,4797,14849,18277,40.3350113,-75.1129124
01/01/2013 12:00:00 AM,42017,Southeast,Bucks County WDA,Bucks,9,25 to 34 Years,Female,33676,1299,7327,7129,3199,9958,4764,14722,17921,40.3350113,-75.1129124
01/01/2010 12:00:00 AM,42017,Southeast,Bucks County WDA,Bucks,9,25 to 34 Years,Female,33035,1507,6907,6588,2719,10552,4762,15314,18033,40.3350113,-75.1129124
01/01/2011 12:00:00 AM,42017,Southeast,Bucks County WDA,Bucks,9,25 to 34 Years,Female,33238,1414,7339,6471,3003,10319,4692,15011,18014,40.3350113,-75.1129124
01/01/2012 12:00:00 AM,42017,Southeast,Bucks County WDA,Bucks,9,25 to 34 Years,Female,33460,1194,7704,6860,3252,9768,4682,14450,17702,40.3350113,-75.1129124
01/01/2010 12:00:00 AM,42017,Southeast,Bucks County WDA,Bucks,9,25 to 34 Years,Male,32823,2013,9370,7389,2076,8654,3321,11975,14051,40.3350113,-75.1129124
01/01/2016 12:00:00 AM,42017,Southeast,Bucks County WDA,Bucks,9,25 to 34 Years,Male,34442,1798,9925,6741,2701,9968,3309,13277,15978,40.3350113,-75.1129124
01/01/2011 12:00:00 AM,42017,Southeast,Bucks County WDA,Bucks,9,25 to 34 Years,Male,33026,2025,9434,7774,1945,8637,3211,11848,13793,40.3350113,-75.1129124
01/01/2015 12:00:00 AM,42017,Southeast,Bucks County WDA,Bucks,9,25 to 34 Years,Male,34109,1794,9757,7378,2422,9578,3180,12758,15180,40.3350113,-75.1129124
01/01/2012 12:00:00 AM,42017,Southeast,Bucks County WDA,Bucks,9,25 to 34 Years,Male,33304,1861,9761,8123,1972,8541,3046,11587,13559,40.3350113,-75.1129124
01/01/2014 12:00:00 AM,42017,Southeast,Bucks County WDA,Bucks,9,25 to 34 Years,Male,33985,1952,9782,7689,2108,9466,2988,12454,14562,40.3350113,-75.1129124
01/01/2013 12:00:00 AM,42017,Southeast,Bucks County WDA,Bucks,9,25 to 34 Years,Male,33656,1994,9930,7790,1977,8999,2966,11965,13942,40.3350113,-75.1129124
01/01/2016 12:00:00 AM,42129,Southwest,Westmoreland-Fayette Counties WDA,Westmoreland,65,45 to 64 Years,Male,54810,3082,21996,8986,6062,9202,5482,14684,20746,40.310315,-79.4713412
01/01/2012 12:00:00 AM,42129,Southwest,Westmoreland-Fayette Counties WDA,Westmoreland,65,45 to 64 Years,Male,55934,2789,22472,9992,5409,9961,5311,15272,20681,40.310315,-79.4713412
01/01/2014 12:00:00 AM,42129,Southwest,Westmoreland-Fayette Counties WDA,Westmoreland,65,45 to 64 Years,Male,55868,2899,22328,9518,5821,10037,5265,15302,21123,40.310315,-79.4713412
01/01/2010 12:00:00 AM,42129,Southwest,Westmoreland-Fayette Counties WDA,Westmoreland,65,45 to 64 Years,Male,54951,2974,22458,9555,5230,9501,5233,14734,19964,40.310315,-79.4713412
01/01/2013 12:00:00 AM,42129,Southwest,Westmoreland-Fayette Counties WDA,Westmoreland,65,45 to 64 Years,Male,56049,3050,22305,9638,5634,10210,5212,15422,21056,40.310315,-79.4713412
01/01/2011 12:00:00 AM,42129,Southwest,Westmoreland-Fayette Counties WDA,Westmoreland,65,45 to 64 Years,Male,55612,2831,22306,10089,5375,9800,5211,15011,20386,40.310315,-79.4713412
01/01/2015 12:00:00 AM,42129,Southwest,Westmoreland-Fayette Counties WDA,Westmoreland,65,45 to 64 Years,Male,55436,2937,22320,9431,5917,9623,5208,14831,20748,40.310315,-79.4713412
01/01/2016 12:00:00 AM,42129,Southwest,Westmoreland-Fayette Counties WDA,Westmoreland,65,45 to 64 Years,Female,56845,2124,21416,10611,7814,9712,5168,14880,22694,40.310315,-79.4713412
01/01/2015 12:00:00 AM,42129,Southwest,Westmoreland-Fayette Counties WDA,Westmoreland,65,45 to 64 Years,Female,57521,2295,21909,10767,7693,9832,5025,14857,22550,40.310315,-79.4713412
01/01/2014 12:00:00 AM,42129,Southwest,Westmoreland-Fayette Counties WDA,Westmoreland,65,45 to 64 Years,Female,57934,2380,23124,10576,7332,9526,4996,14522,21854,40.310315,-79.4713412
01/01/2013 12:00:00 AM,42129,Southwest,Westmoreland-Fayette Counties WDA,Westmoreland,65,45 to 64 Years,Female,58055,2392,23514,10602,7661,9145,4741,13886,21547,40.310315,-79.4713412
01/01/2012 12:00:00 AM,42129,Southwest,Westmoreland-Fayette Counties WDA,Westmoreland,65,45 to 64 Years,Female,57863,2415,24109,10722,7329,8565,4723,13288,20617,40.310315,-79.4713412
01/01/2011 12:00:00 AM,42129,Southwest,Westmoreland-Fayette Counties WDA,Westmoreland,65,45 to 64 Years,Female,57614,2544,24005,10927,7113,8404,4621,13025,20138,40.310315,-79.4713412
01/01/2010 12:00:00 AM,42129,Southwest,Westmoreland-Fayette Counties WDA,Westmoreland,65,45 to 64 Years,Female,56882,2804,24133,10506,6971,7927,4541,12468,19439,40.310315,-79.4713412
01/01/2016 12:00:00 AM,42129,Southwest,Westmoreland-Fayette Counties WDA,Westmoreland,65,35 to 44 Years,Female,20241,608,4683,3515,3060,5522,2853,8375,11435,40.310315,-79.4713412
01/01/2015 12:00:00 AM,42129,Southwest,Westmoreland-Fayette Counties WDA,Westmoreland,65,35 to 44 Years,Female,20847,628,4964,3862,3233,5562,2598,8160,11393,40.310315,-79.4713412
01/01/2014 12:00:00 AM,42129,Southwest,Westmoreland-Fayette Counties WDA,Westmoreland,65,35 to 44 Years,Female,21497,694,5238,4123,3367,5546,2529,8075,11442,40.310315,-79.4713412
01/01/2016 12:00:00 AM,42129,Southwest,Westmoreland-Fayette Counties WDA,Westmoreland,65,25 to 34 Years,Female,17877,776,3666,3653,2688,4599,2495,7094,9782,40.310315,-79.4713412
01/01/2015 12:00:00 AM,42129,Southwest,Westmoreland-Fayette Counties WDA,Westmoreland,65,35 to 44 Years,Male,20816,1029,6833,3949,2428,4150,2427,6577,9005,40.310315,-79.4713412
01/01/2010 12:00:00 AM,42129,Southwest,Westmoreland-Fayette Counties WDA,Westmoreland,65,35 to 44 Years,Female,24583,700,6979,4855,3918,5711,2420,8131,12049,40.310315,-79.4713412
01/01/2011 12:00:00 AM,42129,Southwest,Westmoreland-Fayette Counties WDA,Westmoreland,65,35 to 44 Years,Female,23812,691,6501,4695,3897,5608,2420,8028,11925,40.310315,-79.4713412
01/01/2013 12:00:00 AM,42129,Southwest,Westmoreland-Fayette Counties WDA,Westmoreland,65,35 to 44 Years,Female,22212,783,5865,4096,3431,5622,2415,8037,11468,40.310315,-79.4713412
01/01/2013 12:00:00 AM,42129,Southwest,Westmoreland-Fayette Counties WDA,Westmoreland,65,35 to 44 Years,Male,22083,1119,7821,4152,2462,4123,2406,6529,8991,40.310315,-79.4713412
01/01/2014 12:00:00 AM,42129,Southwest,Westmoreland-Fayette Counties WDA,Westmoreland,65,35 to 44 Years,Male,21379,1157,7073,4025,2370,4354,2400,6754,9124,40.310315,-79.4713412
01/01/2015 12:00:00 AM,42129,Southwest,Westmoreland-Fayette Counties WDA,Westmoreland,65,25 to 34 Years,Female,17889,713,3761,3653,2790,4593,2379,6972,9762,40.310315,-79.4713412
01/01/2011 12:00:00 AM,42129,Southwest,Westmoreland-Fayette Counties WDA,Westmoreland,65,35 to 44 Years,Male,23544,1110,8777,4181,2594,4537,2345,6882,9476,40.310315,-79.4713412
01/01/2014 12:00:00 AM,42129,Southwest,Westmoreland-Fayette Counties WDA,Westmoreland,65,25 to 34 Years,Female,17848,868,3911,3765,2467,4493,2344,6837,9304,40.310315,-79.4713412
01/01/2012 12:00:00 AM,42129,Southwest,Westmoreland-Fayette Counties WDA,Westmoreland,65,35 to 44 Years,Female,23076,681,6085,4695,3757,5546,2312,7858,11615,40.310315,-79.4713412
01/01/2012 12:00:00 AM,42129,Southwest,Westmoreland-Fayette Counties WDA,Westmoreland,65,35 to 44 Years,Male,22804,1097,8245,4243,2547,4387,2285,6672,9219,40.310315,-79.4713412
01/01/2016 12:00:00 AM,42129,Southwest,Westmoreland-Fayette Counties WDA,Westmoreland,65,35 to 44 Years,Male,20207,887,6679,3907,2429,4024,2281,6305,8734,40.310315,-79.4713412
01/01/2010 12:00:00 AM,42129,Southwest,Westmoreland-Fayette Counties WDA,Westmoreland,65,35 to 44 Years,Male,24192,1057,9383,4054,2757,4741,2200,6941,9698,40.310315,-79.4713412
01/01/2013 12:00:00 AM,42129,Southwest,Westmoreland-Fayette Counties WDA,Westmoreland,65,25 to 34 Years,Female,17778,821,4176,3878,2398,4408,2097,6505,8903,40.310315,-79.4713412
01/01/2012 12:00:00 AM,42129,Southwest,Westmoreland-Fayette Counties WDA,Westmoreland,65,25 to 34 Years,Female,17564,747,3994,3795,2299,4693,2036,6729,9028,40.310315,-79.4713412
01/01/2011 12:00:00 AM,42129,Southwest,Westmoreland-Fayette Counties WDA,Westmoreland,65,25 to 34 Years,Female,17453,633,4053,3821,2325,4666,1955,6621,8946,40.310315,-79.4713412
01/01/2010 12:00:00 AM,42129,Southwest,Westmoreland-Fayette Counties WDA,Westmoreland,65,25 to 34 Years,Female,17389,662,3915,3651,2553,4707,1901,6608,9161,40.310315,-79.4713412
01/01/2014 12:00:00 AM,42129,Southwest,Westmoreland-Fayette Counties WDA,Westmoreland,65,25 to 34 Years,Male,18591,1167,6162,3706,2102,3813,1641,5454,7556,40.310315,-79.4713412
01/01/2015 12:00:00 AM,42129,Southwest,Westmoreland-Fayette Counties WDA,Westmoreland,65,25 to 34 Years,Male,18756,1129,6249,3543,2284,3994,1557,5551,7835,40.310315,-79.4713412
01/01/2013 12:00:00 AM,42129,Southwest,Westmoreland-Fayette Counties WDA,Westmoreland,65,25 to 34 Years,Male,18455,1100,6400,3651,2045,3724,1535,5259,7304,40.310315,-79.4713412
01/01/2016 12:00:00 AM,42129,Southwest,Westmoreland-Fayette Counties WDA,Westmoreland,65,25 to 34 Years,Male,18790,1109,6136,3451,2413,4242,1439,5681,8094,40.310315,-79.4713412
01/01/2012 12:00:00 AM,42129,Southwest,Westmoreland-Fayette Counties WDA,Westmoreland,65,25 to 34 Years,Male,18188,1122,6050,3637,2014,4074,1291,5365,7379,40.310315,-79.4713412
01/01/2011 12:00:00 AM,42129,Southwest,Westmoreland-Fayette Counties WDA,Westmoreland,65,25 to 34 Years,Male,18067,1125,6068,3621,2051,3997,1205,5202,7253,40.310315,-79.4713412
01/01/2010 12:00:00 AM,42129,Southwest,Westmoreland-Fayette Counties WDA,Westmoreland,65,25 to 34 Years,Male,17811,1087,6031,3531,1870,4099,1193,5292,7162,40.310315,-79.4713412
01/01/2016 12:00:00 AM,42091,Southeast,Montgomery County WDA,Montgomery,46,45 to 64 Years,Female,119808,4512,28869,18727,11020,31197,25483,56680,67700,40.2098987,-75.37252
01/01/2015 12:00:00 AM,42091,Southeast,Montgomery County WDA,Montgomery,46,45 to 64 Years,Female,119911,4675,29594,18658,10689,31043,25252,56295,66984,40.2098987,-75.37252
01/01/2014 12:00:00 AM,42091,Southeast,Montgomery County WDA,Montgomery,46,45 to 64 Years,Male,112408,6060,29110,18572,6425,27525,24716,52241,58666,40.2098987,-75.37252
01/01/2014 12:00:00 AM,42091,Southeast,Montgomery County WDA,Montgomery,46,45 to 64 Years,Female,119515,4717,30198,19157,10464,30398,24581,54979,65443,40.2098987,-75.37252
01/01/2015 12:00:00 AM,42091,Southeast,Montgomery County WDA,Montgomery,46,45 to 64 Years,Male,112871,5889,29232,18407,6666,28223,24454,52677,59343,40.2098987,-75.37252
01/01/2012 12:00:00 AM,42091,Southeast,Montgomery County WDA,Montgomery,46,45 to 64 Years,Male,110302,5802,28359,18663,6078,27015,24385,51400,57478,40.2098987,-75.37252
01/01/2016 12:00:00 AM,42091,Southeast,Montgomery County WDA,Montgomery,46,45 to 64 Years,Male,112742,5674,29277,17830,6985,28722,24254,52976,59961,40.2098987,-75.37252
01/01/2013 12:00:00 AM,42091,Southeast,Montgomery County WDA,Montgomery,46,45 to 64 Years,Male,111500,5904,29216,18547,6317,27302,24214,51516,57833,40.2098987,-75.37252
01/01/2013 12:00:00 AM,42091,Southeast,Montgomery County WDA,Montgomery,46,45 to 64 Years,Female,118591,4845,30669,19478,10268,29247,24084,53331,63599,40.2098987,-75.37252
01/01/2011 12:00:00 AM,42091,Southeast,Montgomery County WDA,Montgomery,46,45 to 64 Years,Male,108781,5761,28288,18483,5937,26433,23879,50312,56249,40.2098987,-75.37252
01/01/2010 12:00:00 AM,42091,Southeast,Montgomery County WDA,Montgomery,46,45 to 64 Years,Male,106814,5477,27880,17796,5706,26113,23842,49955,55661,40.2098987,-75.37252
01/01/2012 12:00:00 AM,42091,Southeast,Montgomery County WDA,Montgomery,46,45 to 64 Years,Female,117393,4926,30545,19728,9698,28721,23775,52496,62194,40.2098987,-75.37252
01/01/2011 12:00:00 AM,42091,Southeast,Montgomery County WDA,Montgomery,46,45 to 64 Years,Female,115777,5001,31042,19232,9433,27945,23124,51069,60502,40.2098987,-75.37252
01/01/2010 12:00:00 AM,42091,Southeast,Montgomery County WDA,Montgomery,46,45 to 64 Years,Female,113586,5033,31292,18909,9096,26962,22294,49256,58352,40.2098987,-75.37252
01/01/2016 12:00:00 AM,42091,Southeast,Montgomery County WDA,Montgomery,46,35 to 44 Years,Female,51905,1512,7749,7027,4099,16919,14599,31518,35617,40.2098987,-75.37252
01/01/2015 12:00:00 AM,42091,Southeast,Montgomery County WDA,Montgomery,46,35 to 44 Years,Female,52526,1421,8011,7684,4203,16781,14426,31207,35410,40.2098987,-75.37252
01/01/2014 12:00:00 AM,42091,Southeast,Montgomery County WDA,Montgomery,46,35 to 44 Years,Female,53304,1380,8488,8036,4371,17284,13745,31029,35400,40.2098987,-75.37252
01/01/2013 12:00:00 AM,42091,Southeast,Montgomery County WDA,Montgomery,46,35 to 44 Years,Female,54145,1381,8865,8508,4465,17629,13297,30926,35391,40.2098987,-75.37252
01/01/2012 12:00:00 AM,42091,Southeast,Montgomery County WDA,Montgomery,46,35 to 44 Years,Female,55235,1328,9585,8913,5022,17650,12737,30387,35409,40.2098987,-75.37252
01/01/2011 12:00:00 AM,42091,Southeast,Montgomery County WDA,Montgomery,46,35 to 44 Years,Female,56452,1406,10287,9220,5326,17729,12484,30213,35539,40.2098987,-75.37252
01/01/2010 12:00:00 AM,42091,Southeast,Montgomery County WDA,Montgomery,46,35 to 44 Years,Female,57831,1538,11348,9257,5411,18114,12163,30277,35688,40.2098987,-75.37252
01/01/2016 12:00:00 AM,42091,Southeast,Montgomery County WDA,Montgomery,46,35 to 44 Years,Male,50881,2565,10102,7845,3300,14973,12096,27069,30369,40.2098987,-75.37252
01/01/2015 12:00:00 AM,42091,Southeast,Montgomery County WDA,Montgomery,46,35 to 44 Years,Male,51386,2441,10553,8004,3473,15120,11795,26915,30388,40.2098987,-75.37252
01/01/2015 12:00:00 AM,42091,Southeast,Montgomery County WDA,Montgomery,46,25 to 34 Years,Female,50114,1478,6879,7483,3647,18944,11683,30627,34274,40.2098987,-75.37252
01/01/2014 12:00:00 AM,42091,Southeast,Montgomery County WDA,Montgomery,46,35 to 44 Years,Male,51971,2463,10993,8205,3185,15520,11605,27125,30310,40.2098987,-75.37252
01/01/2016 12:00:00 AM,42091,Southeast,Montgomery County WDA,Montgomery,46,25 to 34 Years,Female,50308,1486,6609,7543,3993,19079,11598,30677,34670,40.2098987,-75.37252
01/01/2014 12:00:00 AM,42091,Southeast,Montgomery County WDA,Montgomery,46,25 to 34 Years,Female,49558,1605,6552,7308,3597,18969,11527,30496,34093,40.2098987,-75.37252
01/01/2013 12:00:00 AM,42091,Southeast,Montgomery County WDA,Montgomery,46,35 to 44 Years,Male,52629,2381,11346,8785,3036,15634,11447,27081,30117,40.2098987,-75.37252
01/01/2010 12:00:00 AM,42091,Southeast,Montgomery County WDA,Montgomery,46,35 to 44 Years,Male,55985,2768,13303,8977,3166,16384,11387,27771,30937,40.2098987,-75.37252
01/01/2013 12:00:00 AM,42091,Southeast,Montgomery County WDA,Montgomery,46,25 to 34 Years,Female,48878,1445,6784,7475,3353,18726,11095,29821,33174,40.2098987,-75.37252
01/01/2011 12:00:00 AM,42091,Southeast,Montgomery County WDA,Montgomery,46,35 to 44 Years,Male,54811,2520,12419,9020,3339,16433,11080,27513,30852,40.2098987,-75.37252
01/01/2012 12:00:00 AM,42091,Southeast,Montgomery County WDA,Montgomery,46,35 to 44 Years,Male,53707,2400,11960,9130,3131,16056,11030,27086,30217,40.2098987,-75.37252
01/01/2012 12:00:00 AM,42091,Southeast,Montgomery County WDA,Montgomery,46,25 to 34 Years,Female,48284,1545,6968,7393,3417,18508,10453,28961,32378,40.2098987,-75.37252
01/01/2011 12:00:00 AM,42091,Southeast,Montgomery County WDA,Montgomery,46,25 to 34 Years,Female,47518,1782,6926,7069,3404,18567,9770,28337,31741,40.2098987,-75.37252
01/01/2010 12:00:00 AM,42091,Southeast,Montgomery County WDA,Montgomery,46,25 to 34 Years,Female,46827,1875,6874,7049,3497,17933,9599,27532,31029,40.2098987,-75.37252
01/01/2015 12:00:00 AM,42091,Southeast,Montgomery County WDA,Montgomery,46,25 to 34 Years,Male,50943,2911,11338,8508,3184,17920,7082,25002,28186,40.2098987,-75.37252
01/01/2016 12:00:00 AM,42091,Southeast,Montgomery County WDA,Montgomery,46,25 to 34 Years,Male,51226,2908,11477,8527,2974,18283,7057,25340,28314,40.2098987,-75.37252
01/01/2014 12:00:00 AM,42091,Southeast,Montgomery County WDA,Montgomery,46,25 to 34 Years,Male,50330,2854,11070,8805,3325,17513,6763,24276,27601,40.2098987,-75.37252
01/01/2013 12:00:00 AM,42091,Southeast,Montgomery County WDA,Montgomery,46,25 to 34 Years,Male,49541,2960,11426,8558,3254,16773,6570,23343,26597,40.2098987,-75.37252
01/01/2012 12:00:00 AM,42091,Southeast,Montgomery County WDA,Montgomery,46,25 to 34 Years,Male,48772,2907,10995,8255,3197,16927,6491,23418,26615,40.2098987,-75.37252
01/01/2011 12:00:00 AM,42091,Southeast,Montgomery County WDA,Montgomery,46,25 to 34 Years,Male,47843,3008,10761,8360,3119,16474,6121,22595,25714,40.2098987,-75.37252
01/01/2010 12:00:00 AM,42091,Southeast,Montgomery County WDA,Montgomery,46,25 to 34 Years,Male,47152,3197,10795,7790,2736,16561,6073,22634,25370,40.2098987,-75.37252
01/01/2010 12:00:00 AM,42125,Southwest,Southwest Corner WDA,Washington,63,45 to 64 Years,Male,30385,2474,12933,4455,2295,5276,2952,8228,10523,40.1910966,-80.2518008
01/01/2011 12:00:00 AM,42125,Southwest,Southwest Corner WDA,Washington,63,45 to 64 Years,Male,30792,2628,12792,4508,2454,5470,2940,8410,10864,40.1910966,-80.2518008
01/01/2016 12:00:00 AM,42125,Southwest,Southwest Corner WDA,Washington,63,45 to 64 Years,Female,31911,1556,12965,5104,3597,5826,2863,8689,12286,40.1910966,-80.2518008
01/01/2012 12:00:00 AM,42125,Southwest,Southwest Corner WDA,Washington,63,45 to 64 Years,Male,31032,2599,12685,4840,2514,5561,2833,8394,10908,40.1910966,-80.2518008
01/01/2014 12:00:00 AM,42125,Southwest,Southwest Corner WDA,Washington,63,45 to 64 Years,Male,31058,2384,12707,4735,2561,5852,2819,8671,11232,40.1910966,-80.2518008
01/01/2015 12:00:00 AM,42125,Southwest,Southwest Corner WDA,Washington,63,45 to 64 Years,Female,32084,1547,13202,5035,3934,5568,2798,8366,12300,40.1910966,-80.2518008
01/01/2014 12:00:00 AM,42125,Southwest,Southwest Corner WDA,Washington,63,45 to 64 Years,Female,32187,1717,13437,5122,3836,5300,2775,8075,11911,40.1910966,-80.2518008
01/01/2013 12:00:00 AM,42125,Southwest,Southwest Corner WDA,Washington,63,45 to 64 Years,Female,32221,1871,13739,5328,3532,5047,2704,7751,11283,40.1910966,-80.2518008
01/01/2012 12:00:00 AM,42125,Southwest,Southwest Corner WDA,Washington,63,45 to 64 Years,Female,32061,1955,13926,5139,3331,5013,2697,7710,11041,40.1910966,-80.2518008
01/01/2013 12:00:00 AM,42125,Southwest,Southwest Corner WDA,Washington,63,45 to 64 Years,Male,31133,2505,12698,5002,2349,5890,2689,8579,10928,40.1910966,-80.2518008
01/01/2016 12:00:00 AM,42125,Southwest,Southwest Corner WDA,Washington,63,45 to 64 Years,Male,30767,2037,12822,4625,2587,6014,2682,8696,11283,40.1910966,-80.2518008
01/01/2015 12:00:00 AM,42125,Southwest,Southwest Corner WDA,Washington,63,45 to 64 Years,Male,30963,2225,12667,4583,2719,6132,2637,8769,11488,40.1910966,-80.2518008
01/01/2010 12:00:00 AM,42125,Southwest,Southwest Corner WDA,Washington,63,45 to 64 Years,Female,31330,1998,13853,5255,2999,4623,2602,7225,10224,40.1910966,-80.2518008
01/01/2011 12:00:00 AM,42125,Southwest,Southwest Corner WDA,Washington,63,45 to 64 Years,Female,31801,2086,13879,5231,3209,4823,2573,7396,10605,40.1910966,-80.2518008
01/01/2016 12:00:00 AM,42125,Southwest,Southwest Corner WDA,Washington,63,35 to 44 Years,Female,12162,597,2913,1888,1775,3046,1943,4989,6764,40.1910966,-80.2518008
01/01/2015 12:00:00 AM,42125,Southwest,Southwest Corner WDA,Washington,63,35 to 44 Years,Female,12423,548,3067,1956,1924,3051,1877,4928,6852,40.1910966,-80.2518008
01/01/2013 12:00:00 AM,42125,Southwest,Southwest Corner WDA,Washington,63,35 to 44 Years,Female,12926,437,3723,2319,1652,3098,1697,4795,6447,40.1910966,-80.2518008
01/01/2014 12:00:00 AM,42125,Southwest,Southwest Corner WDA,Washington,63,35 to 44 Years,Female,12673,627,3599,1986,1765,3058,1638,4696,6461,40.1910966,-80.2518008
01/01/2015 12:00:00 AM,42125,Southwest,Southwest Corner WDA,Washington,63,25 to 34 Years,Female,10747,453,2485,1806,1463,2969,1571,4540,6003,40.1910966,-80.2518008
01/01/2016 12:00:00 AM,42125,Southwest,Southwest Corner WDA,Washington,63,25 to 34 Years,Female,10915,413,2369,2121,1527,2933,1552,4485,6012,40.1910966,-80.2518008
01/01/2016 12:00:00 AM,42125,Southwest,Southwest Corner WDA,Washington,63,35 to 44 Years,Male,12148,806,3568,1974,1397,2867,1536,4403,5800,40.1910966,-80.2518008
01/01/2012 12:00:00 AM,42125,Southwest,Southwest Corner WDA,Washington,63,35 to 44 Years,Female,13231,458,3953,2525,1769,2995,1531,4526,6295,40.1910966,-80.2518008
01/01/2011 12:00:00 AM,42125,Southwest,Southwest Corner WDA,Washington,63,35 to 44 Years,Female,13593,512,4187,2432,1814,3154,1494,4648,6462,40.1910966,-80.2518008
01/01/2010 12:00:00 AM,42125,Southwest,Southwest Corner WDA,Washington,63,35 to 44 Years,Female,13894,507,4353,2435,1903,3207,1489,4696,6599,40.1910966,-80.2518008
01/01/2014 12:00:00 AM,42125,Southwest,Southwest Corner WDA,Washington,63,25 to 34 Years,Female,10520,463,2250,1737,1502,3081,1487,4568,6070,40.1910966,-80.2518008
01/01/2011 12:00:00 AM,42125,Southwest,Southwest Corner WDA,Washington,63,35 to 44 Years,Male,13118,621,4293,2165,1572,2986,1481,4467,6039,40.1910966,-80.2518008
01/01/2013 12:00:00 AM,42125,Southwest,Southwest Corner WDA,Washington,63,25 to 34 Years,Female,10434,522,2455,1745,1398,2833,1481,4314,5712,40.1910966,-80.2518008
01/01/2015 12:00:00 AM,42125,Southwest,Southwest Corner WDA,Washington,63,35 to 44 Years,Male,12348,850,3738,2093,1348,2865,1454,4319,5667,40.1910966,-80.2518008
01/01/2014 12:00:00 AM,42125,Southwest,Southwest Corner WDA,Washington,63,35 to 44 Years,Male,12527,779,4193,2138,1188,2776,1453,4229,5417,40.1910966,-80.2518008
01/01/2010 12:00:00 AM,42125,Southwest,Southwest Corner WDA,Washington,63,35 to 44 Years,Male,13412,697,4260,2055,1864,3142,1394,4536,6400,40.1910966,-80.2518008
01/01/2013 12:00:00 AM,42125,Southwest,Southwest Corner WDA,Washington,63,35 to 44 Years,Male,12681,722,4430,2015,1274,2848,1392,4240,5514,40.1910966,-80.2518008
01/01/2012 12:00:00 AM,42125,Southwest,Southwest Corner WDA,Washington,63,35 to 44 Years,Male,12957,661,4161,2135,1498,3153,1349,4502,6000,40.1910966,-80.2518008
01/01/2012 12:00:00 AM,42125,Southwest,Southwest Corner WDA,Washington,63,25 to 34 Years,Female,10404,537,2306,1938,1508,2863,1252,4115,5623,40.1910966,-80.2518008
01/01/2011 12:00:00 AM,42125,Southwest,Southwest Corner WDA,Washington,63,25 to 34 Years,Female,10306,493,2431,1797,1532,2828,1225,4053,5585,40.1910966,-80.2518008
01/01/2010 12:00:00 AM,42125,Southwest,Southwest Corner WDA,Washington,63,25 to 34 Years,Female,10338,484,2527,1864,1688,2762,1013,3775,5463,40.1910966,-80.2518008
01/01/2015 12:00:00 AM,42125,Southwest,Southwest Corner WDA,Washington,63,25 to 34 Years,Male,11104,893,3459,2057,1197,2577,921,3498,4695,40.1910966,-80.2518008
01/01/2014 12:00:00 AM,42125,Southwest,Southwest Corner WDA,Washington,63,25 to 34 Years,Male,10843,916,3175,2032,1302,2519,899,3418,4720,40.1910966,-80.2518008
01/01/2016 12:00:00 AM,42125,Southwest,Southwest Corner WDA,Washington,63,25 to 34 Years,Male,11371,911,3574,2070,1277,2702,837,3539,4816,40.1910966,-80.2518008
01/01/2013 12:00:00 AM,42125,Southwest,Southwest Corner WDA,Washington,63,25 to 34 Years,Male,10616,886,3199,2094,1289,2369,779,3148,4437,40.1910966,-80.2518008
01/01/2012 12:00:00 AM,42125,Southwest,Southwest Corner WDA,Washington,63,25 to 34 Years,Male,10403,758,3336,2047,1190,2404,668,3072,4262,40.1910966,-80.2518008
01/01/2011 12:00:00 AM,42125,Southwest,Southwest Corner WDA,Washington,63,25 to 34 Years,Male,10356,704,3364,1906,1228,2527,627,3154,4382,40.1910966,-80.2518008
01/01/2010 12:00:00 AM,42125,Southwest,Southwest Corner WDA,Washington,63,25 to 34 Years,Male,10231,627,3638,1917,1224,2277,548,2825,4049,40.1910966,-80.2518008
01/01/2013 12:00:00 AM,42041,Central,South Central WDA,Cumberland,21,45 to 64 Years,Male,32520,2330,11251,5210,1994,6602,5133,11735,13729,40.1675984,-77.2686627
01/01/2012 12:00:00 AM,42041,Central,South Central WDA,Cumberland,21,45 to 64 Years,Male,32265,2112,11326,5268,1965,6514,5080,11594,13559,40.1675984,-77.2686627
01/01/2014 12:00:00 AM,42041,Central,South Central WDA,Cumberland,21,45 to 64 Years,Male,32807,2262,11731,4897,2241,6598,5078,11676,13917,40.1675984,-77.2686627
01/01/2010 12:00:00 AM,42041,Central,South Central WDA,Cumberland,21,45 to 64 Years,Male,31129,2291,10754,4992,2018,6138,4936,11074,13092,40.1675984,-77.2686627
01/01/2011 12:00:00 AM,42041,Central,South Central WDA,Cumberland,21,45 to 64 Years,Male,31851,2141,10885,5156,2085,6673,4911,11584,13669,40.1675984,-77.2686627
01/01/2016 12:00:00 AM,42041,Central,South Central WDA,Cumberland,21,45 to 64 Years,Male,32983,2633,11437,5334,2484,6484,4611,11095,13579,40.1675984,-77.2686627
01/01/2015 12:00:00 AM,42041,Central,South Central WDA,Cumberland,21,45 to 64 Years,Male,33003,2517,11884,5080,2390,6547,4585,11132,13522,40.1675984,-77.2686627
01/01/2010 12:00:00 AM,42041,Central,South Central WDA,Cumberland,21,45 to 64 Years,Female,32696,2033,12295,5417,2863,6069,4019,10088,12951,40.1675984,-77.2686627
01/01/2014 12:00:00 AM,42041,Central,South Central WDA,Cumberland,21,45 to 64 Years,Female,33843,1740,12757,5816,3294,6292,3944,10236,13530,40.1675984,-77.2686627
01/01/2012 12:00:00 AM,42041,Central,South Central WDA,Cumberland,21,45 to 64 Years,Female,33645,1869,12392,6130,3314,6004,3936,9940,13254,40.1675984,-77.2686627
01/01/2011 12:00:00 AM,42041,Central,South Central WDA,Cumberland,21,45 to 64 Years,Female,33314,1905,12644,5848,2952,6056,3909,9965,12917,40.1675984,-77.2686627
01/01/2016 12:00:00 AM,42041,Central,South Central WDA,Cumberland,21,45 to 64 Years,Female,33728,2028,11945,5554,3226,7187,3788,10975,14201,40.1675984,-77.2686627
01/01/2013 12:00:00 AM,42041,Central,South Central WDA,Cumberland,21,45 to 64 Years,Female,33797,1881,12554,6135,3396,6143,3688,9831,13227,40.1675984,-77.2686627
01/01/2015 12:00:00 AM,42041,Central,South Central WDA,Cumberland,21,45 to 64 Years,Female,33722,1901,12386,5776,3437,6633,3589,10222,13659,40.1675984,-77.2686627
01/01/2016 12:00:00 AM,42041,Central,South Central WDA,Cumberland,21,35 to 44 Years,Female,14434,692,3707,2218,1342,3808,2667,6475,7817,40.1675984,-77.2686627
01/01/2015 12:00:00 AM,42041,Central,South Central WDA,Cumberland,21,35 to 44 Years,Female,14540,657,3836,2213,1363,3804,2667,6471,7834,40.1675984,-77.2686627
01/01/2014 12:00:00 AM,42041,Central,South Central WDA,Cumberland,21,35 to 44 Years,Female,14523,549,3951,2416,1356,3752,2499,6251,7607,40.1675984,-77.2686627
01/01/2013 12:00:00 AM,42041,Central,South Central WDA,Cumberland,21,35 to 44 Years,Female,14680,660,4016,2366,1452,3852,2334,6186,7638,40.1675984,-77.2686627
01/01/2014 12:00:00 AM,42041,Central,South Central WDA,Cumberland,21,35 to 44 Years,Male,15434,1067,5166,2141,1315,3531,2214,5745,7060,40.1675984,-77.2686627
01/01/2013 12:00:00 AM,42041,Central,South Central WDA,Cumberland,21,35 to 44 Years,Male,15472,1031,5060,2493,1173,3529,2186,5715,6888,40.1675984,-77.2686627
01/01/2016 12:00:00 AM,42041,Central,South Central WDA,Cumberland,21,35 to 44 Years,Male,15334,1052,4746,2466,1228,3668,2174,5842,7070,40.1675984,-77.2686627
01/01/2010 12:00:00 AM,42041,Central,South Central WDA,Cumberland,21,35 to 44 Years,Male,15867,1252,5094,2461,1338,3567,2155,5722,7060,40.1675984,-77.2686627
01/01/2015 12:00:00 AM,42041,Central,South Central WDA,Cumberland,21,35 to 44 Years,Male,15293,1034,5045,2266,1194,3613,2141,5754,6948,40.1675984,-77.2686627
01/01/2012 12:00:00 AM,42041,Central,South Central WDA,Cumberland,21,35 to 44 Years,Male,15590,1174,5175,2384,1166,3555,2136,5691,6857,40.1675984,-77.2686627
01/01/2012 12:00:00 AM,42041,Central,South Central WDA,Cumberland,21,35 to 44 Years,Female,14905,676,4039,2590,1468,4090,2042,6132,7600,40.1675984,-77.2686627
01/01/2011 12:00:00 AM,42041,Central,South Central WDA,Cumberland,21,35 to 44 Years,Male,15810,1205,5110,2484,1294,3685,2032,5717,7011,40.1675984,-77.2686627
01/01/2016 12:00:00 AM,42041,Central,South Central WDA,Cumberland,21,25 to 34 Years,Female,14957,770,3138,3112,1749,4230,1958,6188,7937,40.1675984,-77.2686627
01/01/2015 12:00:00 AM,42041,Central,South Central WDA,Cumberland,21,25 to 34 Years,Female,14603,749,3084,3158,1616,4060,1936,5996,7612,40.1675984,-77.2686627
01/01/2011 12:00:00 AM,42041,Central,South Central WDA,Cumberland,21,35 to 44 Years,Female,15061,724,4214,2584,1453,4177,1909,6086,7539,40.1675984,-77.2686627
01/01/2010 12:00:00 AM,42041,Central,South Central WDA,Cumberland,21,35 to 44 Years,Female,15305,830,4402,2673,1510,3998,1892,5890,7400,40.1675984,-77.2686627
01/01/2014 12:00:00 AM,42041,Central,South Central WDA,Cumberland,21,25 to 34 Years,Female,14299,778,2688,3163,1692,4121,1857,5978,7670,40.1675984,-77.2686627
01/01/2013 12:00:00 AM,42041,Central,South Central WDA,Cumberland,21,25 to 34 Years,Female,13959,704,2825,3061,1608,4046,1715,5761,7369,40.1675984,-77.2686627
01/01/2011 12:00:00 AM,42041,Central,South Central WDA,Cumberland,21,25 to 34 Years,Female,13196,583,2718,2593,1374,4260,1668,5928,7302,40.1675984,-77.2686627
01/01/2010 12:00:00 AM,42041,Central,South Central WDA,Cumberland,21,25 to 34 Years,Female,12956,477,2891,2381,1335,4231,1641,5872,7207,40.1675984,-77.2686627
01/01/2012 12:00:00 AM,42041,Central,South Central WDA,Cumberland,21,25 to 34 Years,Female,13534,547,2819,2865,1589,4101,1613,5714,7303,40.1675984,-77.2686627
01/01/2016 12:00:00 AM,42041,Central,South Central WDA,Cumberland,21,25 to 34 Years,Male,16510,1452,4950,2922,1339,4313,1534,5847,7186,40.1675984,-77.2686627
01/01/2013 12:00:00 AM,42041,Central,South Central WDA,Cumberland,21,25 to 34 Years,Male,15259,1689,4629,2767,998,3929,1247,5176,6174,40.1675984,-77.2686627
01/01/2015 12:00:00 AM,42041,Central,South Central WDA,Cumberland,21,25 to 34 Years,Male,16052,1435,5015,2736,1439,4188,1239,5427,6866,40.1675984,-77.2686627
01/01/2012 12:00:00 AM,42041,Central,South Central WDA,Cumberland,21,25 to 34 Years,Male,14763,1561,4470,2640,924,3938,1230,5168,6092,40.1675984,-77.2686627
01/01/2014 12:00:00 AM,42041,Central,South Central WDA,Cumberland,21,25 to 34 Years,Male,15704,1463,5003,2760,1115,4256,1107,5363,6478,40.1675984,-77.2686627
01/01/2011 12:00:00 AM,42041,Central,South Central WDA,Cumberland,21,25 to 34 Years,Male,14363,1323,4692,2493,934,3825,1096,4921,5855,40.1675984,-77.2686627
01/01/2010 12:00:00 AM,42041,Central,South Central WDA,Cumberland,21,25 to 34 Years,Male,14095,1380,4524,2421,960,3768,1042,4810,5770,40.1675984,-77.2686627
01/01/2016 12:00:00 AM,42071,Southeast,Lancaster County WDA,Lancaster,36,45 to 64 Years,Male,67741,8828,28497,9463,3944,10563,6446,17009,20953,40.045908,-76.2513877
01/01/2015 12:00:00 AM,42071,Southeast,Lancaster County WDA,Lancaster,36,45 to 64 Years,Male,67877,9039,28805,9529,3954,10179,6371,16550,20504,40.045908,-76.2513877
01/01/2016 12:00:00 AM,42071,Southeast,Lancaster County WDA,Lancaster,36,45 to 64 Years,Female,70963,8139,29248,10784,5799,10623,6370,16993,22792,40.045908,-76.2513877
01/01/2013 12:00:00 AM,42071,Southeast,Lancaster County WDA,Lancaster,36,45 to 64 Years,Male,67363,9100,28453,9592,3758,10131,6329,16460,20218,40.045908,-76.2513877
01/01/2015 12:00:00 AM,42071,Southeast,Lancaster County WDA,Lancaster,36,45 to 64 Years,Female,71081,8034,29976,10584,5446,10749,6292,17041,22487,40.045908,-76.2513877
01/01/2012 12:00:00 AM,42071,Southeast,Lancaster County WDA,Lancaster,36,45 to 64 Years,Male,66909,9180,27811,9725,3608,10347,6238,16585,20193,40.045908,-76.2513877
01/01/2014 12:00:00 AM,42071,Southeast,Lancaster County WDA,Lancaster,36,45 to 64 Years,Male,67711,9019,28790,9544,3838,10291,6229,16520,20358,40.045908,-76.2513877
01/01/2014 12:00:00 AM,42071,Southeast,Lancaster County WDA,Lancaster,36,45 to 64 Years,Female,70993,8227,30334,10758,5095,10371,6208,16579,21674,40.045908,-76.2513877
01/01/2011 12:00:00 AM,42071,Southeast,Lancaster County WDA,Lancaster,36,45 to 64 Years,Male,66023,9407,27484,9447,3486,10082,6117,16199,19685,40.045908,-76.2513877
01/01/2010 12:00:00 AM,42071,Southeast,Lancaster County WDA,Lancaster,36,45 to 64 Years,Male,64703,9692,26546,9022,3421,10072,5950,16022,19443,40.045908,-76.2513877
01/01/2013 12:00:00 AM,42071,Southeast,Lancaster County WDA,Lancaster,36,45 to 64 Years,Female,70576,8498,30450,10622,5007,10258,5741,15999,21006,40.045908,-76.2513877
01/01/2012 12:00:00 AM,42071,Southeast,Lancaster County WDA,Lancaster,36,45 to 64 Years,Female,69940,8409,30252,10853,4950,10026,5450,15476,20426,40.045908,-76.2513877
01/01/2010 12:00:00 AM,42071,Southeast,Lancaster County WDA,Lancaster,36,45 to 64 Years,Female,67714,8858,29659,10427,4084,9370,5316,14686,18770,40.045908,-76.2513877
01/01/2011 12:00:00 AM,42071,Southeast,Lancaster County WDA,Lancaster,36,45 to 64 Years,Female,69054,8632,30207,10685,4398,9867,5265,15132,19530,40.045908,-76.2513877
01/01/2016 12:00:00 AM,42071,Southeast,Lancaster County WDA,Lancaster,36,35 to 44 Years,Female,30924,3650,8527,5154,3264,6637,3692,10329,13593,40.045908,-76.2513877
01/01/2015 12:00:00 AM,42071,Southeast,Lancaster County WDA,Lancaster,36,35 to 44 Years,Female,31186,3517,9124,5223,2738,6955,3629,10584,13322,40.045908,-76.2513877
01/01/2013 12:00:00 AM,42071,Southeast,Lancaster County WDA,Lancaster,36,35 to 44 Years,Female,31729,3546,10075,5355,2641,6643,3469,10112,12753,40.045908,-76.2513877
01/01/2014 12:00:00 AM,42071,Southeast,Lancaster County WDA,Lancaster,36,35 to 44 Years,Female,31389,3482,9497,5306,2729,6937,3438,10375,13104,40.045908,-76.2513877
01/01/2016 12:00:00 AM,42071,Southeast,Lancaster County WDA,Lancaster,36,25 to 34 Years,Female,33684,4628,9231,5456,3366,7881,3122,11003,14369,40.045908,-76.2513877
01/01/2012 12:00:00 AM,42071,Southeast,Lancaster County WDA,Lancaster,36,35 to 44 Years,Female,32193,3841,10545,5207,2735,6766,3099,9865,12600,40.045908,-76.2513877
01/01/2011 12:00:00 AM,42071,Southeast,Lancaster County WDA,Lancaster,36,35 to 44 Years,Female,32691,3866,11234,5377,2561,6598,3055,9653,12214,40.045908,-76.2513877
01/01/2015 12:00:00 AM,42071,Southeast,Lancaster County WDA,Lancaster,36,25 to 34 Years,Female,32944,4785,9157,5741,3154,7127,2980,10107,13261,40.045908,-76.2513877
01/01/2014 12:00:00 AM,42071,Southeast,Lancaster County WDA,Lancaster,36,25 to 34 Years,Female,32257,4783,8909,5837,2880,7046,2802,9848,12728,40.045908,-76.2513877
01/01/2010 12:00:00 AM,42071,Southeast,Lancaster County WDA,Lancaster,36,35 to 44 Years,Female,33248,4332,11302,5275,2801,6773,2765,9538,12339,40.045908,-76.2513877
01/01/2013 12:00:00 AM,42071,Southeast,Lancaster County WDA,Lancaster,36,35 to 44 Years,Male,31061,4488,11195,4787,1921,5962,2708,8670,10591,40.045908,-76.2513877
01/01/2010 12:00:00 AM,42071,Southeast,Lancaster County WDA,Lancaster,36,35 to 44 Years,Male,32659,5205,12756,4463,1923,5608,2704,8312,10235,40.045908,-76.2513877
01/01/2011 12:00:00 AM,42071,Southeast,Lancaster County WDA,Lancaster,36,35 to 44 Years,Male,32064,4530,12610,4727,1834,5809,2554,8363,10197,40.045908,-76.2513877
01/01/2012 12:00:00 AM,42071,Southeast,Lancaster County WDA,Lancaster,36,35 to 44 Years,Male,31527,4767,12037,4693,1849,5633,2548,8181,10030,40.045908,-76.2513877
01/01/2014 12:00:00 AM,42071,Southeast,Lancaster County WDA,Lancaster,36,35 to 44 Years,Male,30720,4376,11180,4615,2215,5877,2457,8334,10549,40.045908,-76.2513877
01/01/2016 12:00:00 AM,42071,Southeast,Lancaster County WDA,Lancaster,36,35 to 44 Years,Male,30187,4426,10516,4489,2563,5742,2451,8193,10756,40.045908,-76.2513877
01/01/2012 12:00:00 AM,42071,Southeast,Lancaster County WDA,Lancaster,36,25 to 34 Years,Female,30975,4645,8372,6065,2744,6706,2443,9149,11893,40.045908,-76.2513877
01/01/2010 12:00:00 AM,42071,Southeast,Lancaster County WDA,Lancaster,36,25 to 34 Years,Female,30136,4734,8690,5313,2520,6472,2407,8879,11399,40.045908,-76.2513877
01/01/2015 12:00:00 AM,42071,Southeast,Lancaster County WDA,Lancaster,36,35 to 44 Years,Male,30441,4554,11016,4440,2221,5885,2325,8210,10431,40.045908,-76.2513877
01/01/2013 12:00:00 AM,42071,Southeast,Lancaster County WDA,Lancaster,36,25 to 34 Years,Female,31553,5096,8610,5842,2697,7045,2263,9308,12005,40.045908,-76.2513877
01/01/2011 12:00:00 AM,42071,Southeast,Lancaster County WDA,Lancaster,36,25 to 34 Years,Female,30532,4813,8476,5992,2513,6516,2222,8738,11251,40.045908,-76.2513877
01/01/2016 12:00:00 AM,42071,Southeast,Lancaster County WDA,Lancaster,36,25 to 34 Years,Male,33560,5997,11285,5060,2832,6521,1865,8386,11218,40.045908,-76.2513877
01/01/2015 12:00:00 AM,42071,Southeast,Lancaster County WDA,Lancaster,36,25 to 34 Years,Male,32685,5662,11419,4672,2706,6439,1787,8226,10932,40.045908,-76.2513877
01/01/2014 12:00:00 AM,42071,Southeast,Lancaster County WDA,Lancaster,36,25 to 34 Years,Male,31830,5537,11214,4627,2580,6147,1725,7872,10452,40.045908,-76.2513877
01/01/2013 12:00:00 AM,42071,Southeast,Lancaster County WDA,Lancaster,36,25 to 34 Years,Male,31055,5334,10694,4789,2621,6023,1594,7617,10238,40.045908,-76.2513877
01/01/2012 12:00:00 AM,42071,Southeast,Lancaster County WDA,Lancaster,36,25 to 34 Years,Male,30453,5020,10860,4667,2684,5782,1440,7222,9906,40.045908,-76.2513877
01/01/2011 12:00:00 AM,42071,Southeast,Lancaster County WDA,Lancaster,36,25 to 34 Years,Male,29965,4876,10519,4948,2554,5751,1317,7068,9622,40.045908,-76.2513877
01/01/2010 12:00:00 AM,42071,Southeast,Lancaster County WDA,Lancaster,36,25 to 34 Years,Male,29570,4876,10358,4739,2506,5796,1295,7091,9597,40.045908,-76.2513877
01/01/2016 12:00:00 AM,42009,Southwest,Southern Alleghenies WDA,Bedford,5,45 to 64 Years,Female,7274,584,3904,1196,568,636,386,1022,1590,40.0073754,-78.4911647
01/01/2016 12:00:00 AM,42009,Southwest,Southern Alleghenies WDA,Bedford,5,45 to 64 Years,Male,7387,714,4521,880,384,521,367,888,1272,40.0073754,-78.4911647
01/01/2010 12:00:00 AM,42009,Southwest,Southern Alleghenies WDA,Bedford,5,45 to 64 Years,Female,7148,681,3792,1038,618,667,352,1019,1637,40.0073754,-78.4911647
01/01/2014 12:00:00 AM,42009,Southwest,Southern Alleghenies WDA,Bedford,5,45 to 64 Years,Male,7407,883,4294,957,412,528,333,861,1273,40.0073754,-78.4911647
01/01/2015 12:00:00 AM,42009,Southwest,Southern Alleghenies WDA,Bedford,5,45 to 64 Years,Male,7410,784,4410,933,393,559,331,890,1283,40.0073754,-78.4911647
01/01/2013 12:00:00 AM,42009,Southwest,Southern Alleghenies WDA,Bedford,5,45 to 64 Years,Male,7381,901,4197,948,438,575,322,897,1335,40.0073754,-78.4911647
01/01/2015 12:00:00 AM,42009,Southwest,Southern Alleghenies WDA,Bedford,5,45 to 64 Years,Female,7264,676,3880,1185,588,622,313,935,1523,40.0073754,-78.4911647
01/01/2011 12:00:00 AM,42009,Southwest,Southern Alleghenies WDA,Bedford,5,45 to 64 Years,Female,7181,670,3744,1147,676,636,308,944,1620,40.0073754,-78.4911647
01/01/2012 12:00:00 AM,42009,Southwest,Southern Alleghenies WDA,Bedford,5,45 to 64 Years,Male,7304,913,4145,907,465,578,296,874,1339,40.0073754,-78.4911647
01/01/2011 12:00:00 AM,42009,Southwest,Southern Alleghenies WDA,Bedford,5,45 to 64 Years,Male,7245,953,4076,928,461,541,286,827,1288,40.0073754,-78.4911647
01/01/2014 12:00:00 AM,42009,Southwest,Southern Alleghenies WDA,Bedford,5,45 to 64 Years,Female,7258,597,3833,1281,639,623,285,908,1547,40.0073754,-78.4911647
01/01/2010 12:00:00 AM,42009,Southwest,Southern Alleghenies WDA,Bedford,5,45 to 64 Years,Male,7184,960,4041,856,455,587,285,872,1327,40.0073754,-78.4911647
01/01/2016 12:00:00 AM,42009,Southwest,Southern Alleghenies WDA,Bedford,5,25 to 34 Years,Female,2346,280,719,499,326,267,255,522,848,40.0073754,-78.4911647
01/01/2012 12:00:00 AM,42009,Southwest,Southern Alleghenies WDA,Bedford,5,45 to 64 Years,Female,7218,623,3820,1218,684,640,233,873,1557,40.0073754,-78.4911647
01/01/2013 12:00:00 AM,42009,Southwest,Southern Alleghenies WDA,Bedford,5,45 to 64 Years,Female,7281,604,3856,1275,669,646,231,877,1546,40.0073754,-78.4911647
01/01/2015 12:00:00 AM,42009,Southwest,Southern Alleghenies WDA,Bedford,5,25 to 34 Years,Female,2379,232,815,486,307,313,226,539,846,40.0073754,-78.4911647
01/01/2014 12:00:00 AM,42009,Southwest,Southern Alleghenies WDA,Bedford,5,25 to 34 Years,Female,2389,215,785,501,328,363,197,560,888,40.0073754,-78.4911647
01/01/2010 12:00:00 AM,42009,Southwest,Southern Alleghenies WDA,Bedford,5,25 to 34 Years,Female,2529,113,1154,475,279,364,144,508,787,40.0073754,-78.4911647
01/01/2015 12:00:00 AM,42009,Southwest,Southern Alleghenies WDA,Bedford,5,35 to 44 Years,Female,2968,212,1209,586,471,353,137,490,961,40.0073754,-78.4911647
01/01/2010 12:00:00 AM,42009,Southwest,Southern Alleghenies WDA,Bedford,5,35 to 44 Years,Male,3616,452,1905,457,316,350,136,486,802,40.0073754,-78.4911647
01/01/2016 12:00:00 AM,42009,Southwest,Southern Alleghenies WDA,Bedford,5,35 to 44 Years,Female,2886,197,1181,625,409,346,128,474,883,40.0073754,-78.4911647
01/01/2013 12:00:00 AM,42009,Southwest,Southern Alleghenies WDA,Bedford,5,25 to 34 Years,Female,2434,119,919,576,333,366,121,487,820,40.0073754,-78.4911647
01/01/2016 12:00:00 AM,42009,Southwest,Southern Alleghenies WDA,Bedford,5,25 to 34 Years,Male,2517,258,1145,473,271,256,114,370,641,40.0073754,-78.4911647
01/01/2014 12:00:00 AM,42009,Southwest,Southern Alleghenies WDA,Bedford,5,35 to 44 Years,Female,3013,252,1285,598,397,373,108,481,878,40.0073754,-78.4911647
01/01/2013 12:00:00 AM,42009,Southwest,Southern Alleghenies WDA,Bedford,5,35 to 44 Years,Female,3099,258,1382,558,416,378,107,485,901,40.0073754,-78.4911647
01/01/2012 12:00:00 AM,42009,Southwest,Southern Alleghenies WDA,Bedford,5,25 to 34 Years,Female,2470,115,953,600,327,369,106,475,802,40.0073754,-78.4911647
01/01/2011 12:00:00 AM,42009,Southwest,Southern Alleghenies WDA,Bedford,5,25 to 34 Years,Female,2508,126,1110,526,274,367,105,472,746,40.0073754,-78.4911647
01/01/2011 12:00:00 AM,42009,Southwest,Southern Alleghenies WDA,Bedford,5,35 to 44 Years,Male,3493,495,1735,465,356,340,102,442,798,40.0073754,-78.4911647
01/01/2012 12:00:00 AM,42009,Southwest,Southern Alleghenies WDA,Bedford,5,35 to 44 Years,Female,3163,183,1410,573,550,348,99,447,997,40.0073754,-78.4911647
01/01/2015 12:00:00 AM,42009,Southwest,Southern Alleghenies WDA,Bedford,5,35 to 44 Years,Male,2966,292,1512,414,391,264,93,357,748,40.0073754,-78.4911647
01/01/2015 12:00:00 AM,42009,Southwest,Southern Alleghenies WDA,Bedford,5,25 to 34 Years,Male,2501,336,1089,484,221,282,89,371,592,40.0073754,-78.4911647
01/01/2016 12:00:00 AM,42009,Southwest,Southern Alleghenies WDA,Bedford,5,35 to 44 Years,Male,2863,233,1460,413,395,273,89,362,757,40.0073754,-78.4911647
01/01/2011 12:00:00 AM,42009,Southwest,Southern Alleghenies WDA,Bedford,5,35 to 44 Years,Female,3218,199,1468,604,486,375,86,461,947,40.0073754,-78.4911647
01/01/2014 12:00:00 AM,42009,Southwest,Southern Alleghenies WDA,Bedford,5,25 to 34 Years,Male,2465,344,1020,499,210,313,79,392,602,40.0073754,-78.4911647
01/01/2010 12:00:00 AM,42009,Southwest,Southern Alleghenies WDA,Bedford,5,35 to 44 Years,Female,3284,196,1507,674,449,380,78,458,907,40.0073754,-78.4911647
01/01/2012 12:00:00 AM,42009,Southwest,Southern Alleghenies WDA,Bedford,5,35 to 44 Years,Male,3368,441,1701,479,349,326,72,398,747,40.0073754,-78.4911647
01/01/2013 12:00:00 AM,42009,Southwest,Southern Alleghenies WDA,Bedford,5,35 to 44 Years,Male,3199,355,1539,519,410,311,65,376,786,40.0073754,-78.4911647
01/01/2014 12:00:00 AM,42009,Southwest,Southern Alleghenies WDA,Bedford,5,35 to 44 Years,Male,3095,308,1504,499,403,321,60,381,784,40.0073754,-78.4911647
01/01/2010 12:00:00 AM,42009,Southwest,Southern Alleghenies WDA,Bedford,5,25 to 34 Years,Male,2521,242,1319,366,208,346,40,386,594,40.0073754,-78.4911647
01/01/2013 12:00:00 AM,42009,Southwest,Southern Alleghenies WDA,Bedford,5,25 to 34 Years,Male,2464,298,1222,445,168,293,38,331,499,40.0073754,-78.4911647
01/01/2012 12:00:00 AM,42009,Southwest,Southern Alleghenies WDA,Bedford,5,25 to 34 Years,Male,2486,282,1256,423,190,305,30,335,525,40.0073754,-78.4911647
01/01/2011 12:00:00 AM,42009,Southwest,Southern Alleghenies WDA,Bedford,5,25 to 34 Years,Male,2512,289,1225,428,214,327,29,356,570,40.0073754,-78.4911647
01/01/2016 12:00:00 AM,42101,Southeast,Philadelphia County WDA,Philadelphia,51,25 to 34 Years,Female,146321,13345,34554,26043,8928,39505,23946,63451,72379,40.0044435,-75.140236
01/01/2015 12:00:00 AM,42101,Southeast,Philadelphia County WDA,Philadelphia,51,25 to 34 Years,Female,142845,13945,34571,25824,8513,37326,22666,59992,68505,40.0044435,-75.140236
01/01/2014 12:00:00 AM,42101,Southeast,Philadelphia County WDA,Philadelphia,51,25 to 34 Years,Female,138499,14137,34683,24650,8563,35151,21315,56466,65029,40.0044435,-75.140236
01/01/2013 12:00:00 AM,42101,Southeast,Philadelphia County WDA,Philadelphia,51,25 to 34 Years,Female,134521,13256,34793,24908,7797,33015,20752,53767,61564,40.0044435,-75.140236
01/01/2012 12:00:00 AM,42101,Southeast,Philadelphia County WDA,Philadelphia,51,25 to 34 Years,Female,129823,13687,33530,24123,8098,30539,19846,50385,58483,40.0044435,-75.140236
01/01/2011 12:00:00 AM,42101,Southeast,Philadelphia County WDA,Philadelphia,51,25 to 34 Years,Female,126946,13400,33425,22892,8926,29941,18362,48303,57229,40.0044435,-75.140236
01/01/2016 12:00:00 AM,42101,Southeast,Philadelphia County WDA,Philadelphia,51,45 to 64 Years,Female,196746,34222,69756,38291,14907,21685,17885,39570,54477,40.0044435,-75.140236
01/01/2013 12:00:00 AM,42101,Southeast,Philadelphia County WDA,Philadelphia,51,45 to 64 Years,Female,194307,35517,70474,38100,13150,19349,17717,37066,50216,40.0044435,-75.140236
01/01/2014 12:00:00 AM,42101,Southeast,Philadelphia County WDA,Philadelphia,51,45 to 64 Years,Female,195502,35155,70788,38757,13245,19962,17595,37557,50802,40.0044435,-75.140236
01/01/2010 12:00:00 AM,42101,Southeast,Philadelphia County WDA,Philadelphia,51,25 to 34 Years,Female,124318,13487,33854,22343,8698,28462,17474,45936,54634,40.0044435,-75.140236
01/01/2012 12:00:00 AM,42101,Southeast,Philadelphia County WDA,Philadelphia,51,45 to 64 Years,Female,192432,36536,69982,36846,12739,19076,17253,36329,49068,40.0044435,-75.140236
01/01/2015 12:00:00 AM,42101,Southeast,Philadelphia County WDA,Philadelphia,51,45 to 64 Years,Female,196581,35037,70758,38537,14261,20864,17124,37988,52249,40.0044435,-75.140236
01/01/2010 12:00:00 AM,42101,Southeast,Philadelphia County WDA,Philadelphia,51,45 to 64 Years,Female,188466,36819,70964,32964,11892,18779,17048,35827,47719,40.0044435,-75.140236
01/01/2011 12:00:00 AM,42101,Southeast,Philadelphia County WDA,Philadelphia,51,45 to 64 Years,Female,190639,36669,70621,35165,12294,18911,16979,35890,48184,40.0044435,-75.140236
01/01/2016 12:00:00 AM,42101,Southeast,Philadelphia County WDA,Philadelphia,51,25 to 34 Years,Male,135542,15928,39131,23220,6586,34099,16578,50677,57263,40.0044435,-75.140236
01/01/2015 12:00:00 AM,42101,Southeast,Philadelphia County WDA,Philadelphia,51,25 to 34 Years,Male,131626,16396,37702,23879,6077,31957,15615,47572,53649,40.0044435,-75.140236
01/01/2014 12:00:00 AM,42101,Southeast,Philadelphia County WDA,Philadelphia,51,25 to 34 Years,Male,127417,16391,38108,22863,5425,29764,14866,44630,50055,40.0044435,-75.140236
01/01/2013 12:00:00 AM,42101,Southeast,Philadelphia County WDA,Philadelphia,51,25 to 34 Years,Male,123290,15221,36121,23643,5154,28517,14634,43151,48305,40.0044435,-75.140236
01/01/2016 12:00:00 AM,42101,Southeast,Philadelphia County WDA,Philadelphia,51,45 to 64 Years,Male,170619,33745,66212,28904,8123,19540,14095,33635,41758,40.0044435,-75.140236
01/01/2015 12:00:00 AM,42101,Southeast,Philadelphia County WDA,Philadelphia,51,45 to 64 Years,Male,170467,34654,66196,28503,8126,18911,14077,32988,41114,40.0044435,-75.140236
01/01/2014 12:00:00 AM,42101,Southeast,Philadelphia County WDA,Philadelphia,51,45 to 64 Years,Male,169358,34801,65859,28766,7717,18140,14075,32215,39932,40.0044435,-75.140236
01/01/2013 12:00:00 AM,42101,Southeast,Philadelphia County WDA,Philadelphia,51,45 to 64 Years,Male,167881,34542,64773,28896,8414,17337,13919,31256,39670,40.0044435,-75.140236
01/01/2012 12:00:00 AM,42101,Southeast,Philadelphia County WDA,Philadelphia,51,25 to 34 Years,Male,118987,14868,35050,21958,5473,27796,13842,41638,47111,40.0044435,-75.140236
01/01/2010 12:00:00 AM,42101,Southeast,Philadelphia County WDA,Philadelphia,51,45 to 64 Years,Male,161206,33982,61276,27228,7981,17055,13684,30739,38720,40.0044435,-75.140236
01/01/2012 12:00:00 AM,42101,Southeast,Philadelphia County WDA,Philadelphia,51,45 to 64 Years,Male,165689,35586,63586,28248,8323,16516,13430,29946,38269,40.0044435,-75.140236
01/01/2011 12:00:00 AM,42101,Southeast,Philadelphia County WDA,Philadelphia,51,45 to 64 Years,Male,163720,34706,62946,27637,8338,16781,13312,30093,38431,40.0044435,-75.140236
01/01/2011 12:00:00 AM,42101,Southeast,Philadelphia County WDA,Philadelphia,51,25 to 34 Years,Male,116033,13900,35001,21291,5803,26760,13278,40038,45841,40.0044435,-75.140236
01/01/2010 12:00:00 AM,42101,Southeast,Philadelphia County WDA,Philadelphia,51,25 to 34 Years,Male,113279,14215,35631,19375,6150,25049,12859,37908,44058,40.0044435,-75.140236
01/01/2016 12:00:00 AM,42101,Southeast,Philadelphia County WDA,Philadelphia,51,35 to 44 Years,Female,99292,13283,28732,20552,8149,16064,12512,28576,36725,40.0044435,-75.140236
01/01/2015 12:00:00 AM,42101,Southeast,Philadelphia County WDA,Philadelphia,51,35 to 44 Years,Female,98926,13800,29246,20864,8036,15412,11568,26980,35016,40.0044435,-75.140236
01/01/2014 12:00:00 AM,42101,Southeast,Philadelphia County WDA,Philadelphia,51,35 to 44 Years,Female,98263,14436,29986,20808,7545,14197,11291,25488,33033,40.0044435,-75.140236
01/01/2013 12:00:00 AM,42101,Southeast,Philadelphia County WDA,Philadelphia,51,35 to 44 Years,Female,97932,14326,31259,21496,6765,13766,10320,24086,30851,40.0044435,-75.140236
01/01/2012 12:00:00 AM,42101,Southeast,Philadelphia County WDA,Philadelphia,51,35 to 44 Years,Female,97976,13844,33168,20144,7426,13437,9957,23394,30820,40.0044435,-75.140236
01/01/2011 12:00:00 AM,42101,Southeast,Philadelphia County WDA,Philadelphia,51,35 to 44 Years,Female,98935,14911,34894,19363,7601,12748,9418,22166,29767,40.0044435,-75.140236
01/01/2015 12:00:00 AM,42101,Southeast,Philadelphia County WDA,Philadelphia,51,35 to 44 Years,Male,91366,14191,34063,15488,4503,13753,9368,23121,27624,40.0044435,-75.140236
01/01/2016 12:00:00 AM,42101,Southeast,Philadelphia County WDA,Philadelphia,51,35 to 44 Years,Male,91402,14487,33437,15629,4366,14215,9268,23483,27849,40.0044435,-75.140236
01/01/2010 12:00:00 AM,42101,Southeast,Philadelphia County WDA,Philadelphia,51,35 to 44 Years,Female,100170,15146,36729,19025,7924,12300,9046,21346,29270,40.0044435,-75.140236
01/01/2014 12:00:00 AM,42101,Southeast,Philadelphia County WDA,Philadelphia,51,35 to 44 Years,Male,91107,14886,34224,15842,4370,12747,9038,21785,26155,40.0044435,-75.140236
01/01/2012 12:00:00 AM,42101,Southeast,Philadelphia County WDA,Philadelphia,51,35 to 44 Years,Male,90900,15326,34049,17143,4534,11195,8653,19848,24382,40.0044435,-75.140236
01/01/2013 12:00:00 AM,42101,Southeast,Philadelphia County WDA,Philadelphia,51,35 to 44 Years,Male,91159,14534,34748,16740,4501,12168,8468,20636,25137,40.0044435,-75.140236
01/01/2011 12:00:00 AM,42101,Southeast,Philadelphia County WDA,Philadelphia,51,35 to 44 Years,Male,91455,14829,35645,16992,4599,11246,8144,19390,23989,40.0044435,-75.140236
01/01/2010 12:00:00 AM,42101,Southeast,Philadelphia County WDA,Philadelphia,51,35 to 44 Years,Male,92237,16326,36030,16048,4937,11118,7778,18896,23833,40.0044435,-75.140236
01/01/2011 12:00:00 AM,42029,Southeast,Chester County WDA,Chester,15,45 to 64 Years,Male,68862,4330,15487,9725,3508,19016,16796,35812,39320,39.9748706,-75.756265
01/01/2014 12:00:00 AM,42029,Southeast,Chester County WDA,Chester,15,45 to 64 Years,Male,71954,4200,17262,9936,3966,19880,16710,36590,40556,39.9748706,-75.756265
01/01/2013 12:00:00 AM,42029,Southeast,Chester County WDA,Chester,15,45 to 64 Years,Male,71109,4155,16712,10057,3822,19735,16628,36363,40185,39.9748706,-75.756265
01/01/2010 12:00:00 AM,42029,Southeast,Chester County WDA,Chester,15,45 to 64 Years,Male,67198,3968,15257,9608,3467,18370,16528,34898,38365,39.9748706,-75.756265
01/01/2015 12:00:00 AM,42029,Southeast,Chester County WDA,Chester,15,45 to 64 Years,Male,72445,4404,17222,10114,4311,19896,16498,36394,40705,39.9748706,-75.756265
01/01/2012 12:00:00 AM,42029,Southeast,Chester County WDA,Chester,15,45 to 64 Years,Male,70028,4350,16015,10412,3557,19295,16399,35694,39251,39.9748706,-75.756265
01/01/2016 12:00:00 AM,42029,Southeast,Chester County WDA,Chester,15,45 to 64 Years,Male,72456,4330,16794,10317,4374,20587,16054,36641,41015,39.9748706,-75.756265
01/01/2016 12:00:00 AM,42029,Southeast,Chester County WDA,Chester,15,45 to 64 Years,Female,75476,3441,16467,10813,6057,23442,15256,38698,44755,39.9748706,-75.756265
01/01/2015 12:00:00 AM,42029,Southeast,Chester County WDA,Chester,15,45 to 64 Years,Female,75401,3657,16959,11097,5991,22975,14722,37697,43688,39.9748706,-75.756265
01/01/2014 12:00:00 AM,42029,Southeast,Chester County WDA,Chester,15,45 to 64 Years,Female,74862,3430,17788,11571,5684,22369,14020,36389,42073,39.9748706,-75.756265
01/01/2013 12:00:00 AM,42029,Southeast,Chester County WDA,Chester,15,45 to 64 Years,Female,74012,3311,17683,11925,5839,22003,13251,35254,41093,39.9748706,-75.756265
01/01/2012 12:00:00 AM,42029,Southeast,Chester County WDA,Chester,15,45 to 64 Years,Female,72796,3477,17998,11679,5676,21307,12659,33966,39642,39.9748706,-75.756265
01/01/2011 12:00:00 AM,42029,Southeast,Chester County WDA,Chester,15,45 to 64 Years,Female,71436,3583,17753,11770,5542,20237,12551,32788,38330,39.9748706,-75.756265
01/01/2010 12:00:00 AM,42029,Southeast,Chester County WDA,Chester,15,45 to 64 Years,Female,69641,3564,17985,11580,5502,19009,12001,31010,36512,39.9748706,-75.756265
01/01/2016 12:00:00 AM,42029,Southeast,Chester County WDA,Chester,15,35 to 44 Years,Female,32468,1852,4222,3873,1960,12025,8536,20561,22521,39.9748706,-75.756265
01/01/2015 12:00:00 AM,42029,Southeast,Chester County WDA,Chester,15,35 to 44 Years,Female,33068,1699,4587,4168,2178,12051,8385,20436,22614,39.9748706,-75.756265
01/01/2014 12:00:00 AM,42029,Southeast,Chester County WDA,Chester,15,35 to 44 Years,Female,33555,1568,5003,4164,2297,12445,8078,20523,22820,39.9748706,-75.756265
01/01/2013 12:00:00 AM,42029,Southeast,Chester County WDA,Chester,15,35 to 44 Years,Female,34306,1526,5322,4157,2446,12784,8071,20855,23301,39.9748706,-75.756265
01/01/2012 12:00:00 AM,42029,Southeast,Chester County WDA,Chester,15,35 to 44 Years,Female,35250,1431,5870,4524,2754,12958,7713,20671,23425,39.9748706,-75.756265
01/01/2011 12:00:00 AM,42029,Southeast,Chester County WDA,Chester,15,35 to 44 Years,Female,36032,1555,6137,4815,2823,13101,7601,20702,23525,39.9748706,-75.756265
01/01/2011 12:00:00 AM,42029,Southeast,Chester County WDA,Chester,15,35 to 44 Years,Male,34724,1893,6774,4667,2164,11805,7421,19226,21390,39.9748706,-75.756265
01/01/2015 12:00:00 AM,42029,Southeast,Chester County WDA,Chester,15,35 to 44 Years,Male,32213,2130,6155,3877,1642,11020,7389,18409,20051,39.9748706,-75.756265
01/01/2014 12:00:00 AM,42029,Southeast,Chester County WDA,Chester,15,35 to 44 Years,Male,32585,2137,6207,3880,1732,11262,7367,18629,20361,39.9748706,-75.756265
01/01/2013 12:00:00 AM,42029,Southeast,Chester County WDA,Chester,15,35 to 44 Years,Male,33107,2090,6415,4094,1812,11332,7364,18696,20508,39.9748706,-75.756265
01/01/2012 12:00:00 AM,42029,Southeast,Chester County WDA,Chester,15,35 to 44 Years,Male,33867,2121,6646,4397,1793,11570,7340,18910,20703,39.9748706,-75.756265
01/01/2016 12:00:00 AM,42029,Southeast,Chester County WDA,Chester,15,35 to 44 Years,Male,31835,2407,5775,3856,1509,10984,7304,18288,19797,39.9748706,-75.756265
01/01/2010 12:00:00 AM,42029,Southeast,Chester County WDA,Chester,15,35 to 44 Years,Male,35490,2001,7087,5117,2002,11986,7297,19283,21285,39.9748706,-75.756265
01/01/2010 12:00:00 AM,42029,Southeast,Chester County WDA,Chester,15,35 to 44 Years,Female,36821,1763,6799,4797,3010,13468,6984,20452,23462,39.9748706,-75.756265
01/01/2016 12:00:00 AM,42029,Southeast,Chester County WDA,Chester,15,25 to 34 Years,Female,28533,1523,4713,3840,1715,11022,5720,16742,18457,39.9748706,-75.756265
01/01/2014 12:00:00 AM,42029,Southeast,Chester County WDA,Chester,15,25 to 34 Years,Female,27961,1693,4410,4213,1617,10548,5480,16028,17645,39.9748706,-75.756265
01/01/2015 12:00:00 AM,42029,Southeast,Chester County WDA,Chester,15,25 to 34 Years,Female,28320,1737,4520,4137,1668,10855,5403,16258,17926,39.9748706,-75.756265
01/01/2013 12:00:00 AM,42029,Southeast,Chester County WDA,Chester,15,25 to 34 Years,Female,27544,1560,4176,4119,1734,10811,5144,15955,17689,39.9748706,-75.756265
01/01/2012 12:00:00 AM,42029,Southeast,Chester County WDA,Chester,15,25 to 34 Years,Female,27271,1777,3745,3819,1590,11306,5034,16340,17930,39.9748706,-75.756265
01/01/2010 12:00:00 AM,42029,Southeast,Chester County WDA,Chester,15,25 to 34 Years,Female,26766,1602,3671,3475,1482,11836,4700,16536,18018,39.9748706,-75.756265
01/01/2011 12:00:00 AM,42029,Southeast,Chester County WDA,Chester,15,25 to 34 Years,Female,27037,1810,3653,3853,1611,11529,4581,16110,17721,39.9748706,-75.756265
01/01/2015 12:00:00 AM,42029,Southeast,Chester County WDA,Chester,15,25 to 34 Years,Male,29009,2951,6575,5107,1565,9170,3641,12811,14376,39.9748706,-75.756265
01/01/2016 12:00:00 AM,42029,Southeast,Chester County WDA,Chester,15,25 to 34 Years,Male,29414,2909,6327,4755,1780,10060,3583,13643,15423,39.9748706,-75.756265
01/01/2012 12:00:00 AM,42029,Southeast,Chester County WDA,Chester,15,25 to 34 Years,Male,27587,2319,6514,4741,1723,8743,3547,12290,14013,39.9748706,-75.756265
01/01/2014 12:00:00 AM,42029,Southeast,Chester County WDA,Chester,15,25 to 34 Years,Male,28527,2664,7026,4886,1622,8850,3479,12329,13951,39.9748706,-75.756265
01/01/2013 12:00:00 AM,42029,Southeast,Chester County WDA,Chester,15,25 to 34 Years,Male,28094,2589,6829,4921,1743,8615,3397,12012,13755,39.9748706,-75.756265
01/01/2011 12:00:00 AM,42029,Southeast,Chester County WDA,Chester,15,25 to 34 Years,Male,27107,2249,6580,4643,1623,8726,3286,12012,13635,39.9748706,-75.756265
01/01/2010 12:00:00 AM,42029,Southeast,Chester County WDA,Chester,15,25 to 34 Years,Male,26794,2184,6277,4425,1574,9267,3067,12334,13908,39.9748706,-75.756265
01/01/2010 12:00:00 AM,42111,Southwest,Southern Alleghenies WDA,Somerset,56,45 to 64 Years,Female,11079,1332,5390,1570,906,1120,761,1881,2787,39.971463,-79.0310021
01/01/2011 12:00:00 AM,42111,Southwest,Southern Alleghenies WDA,Somerset,56,45 to 64 Years,Male,12405,1626,6627,1379,651,1411,711,2122,2773,39.971463,-79.0310021
01/01/2011 12:00:00 AM,42111,Southwest,Southern Alleghenies WDA,Somerset,56,45 to 64 Years,Female,11153,1293,5423,1579,1024,1123,711,1834,2858,39.971463,-79.0310021
01/01/2010 12:00:00 AM,42111,Southwest,Southern Alleghenies WDA,Somerset,56,45 to 64 Years,Male,12019,1595,6495,1318,552,1365,694,2059,2611,39.971463,-79.0310021
01/01/2013 12:00:00 AM,42111,Southwest,Southern Alleghenies WDA,Somerset,56,45 to 64 Years,Female,11238,1091,5594,1688,1029,1173,663,1836,2865,39.971463,-79.0310021
01/01/2015 12:00:00 AM,42111,Southwest,Southern Alleghenies WDA,Somerset,56,45 to 64 Years,Female,11040,997,5296,1572,1163,1351,661,2012,3175,39.971463,-79.0310021
01/01/2014 12:00:00 AM,42111,Southwest,Southern Alleghenies WDA,Somerset,56,45 to 64 Years,Female,11148,1035,5443,1702,1029,1279,660,1939,2968,39.971463,-79.0310021
01/01/2012 12:00:00 AM,42111,Southwest,Southern Alleghenies WDA,Somerset,56,45 to 64 Years,Male,12331,1609,6676,1423,655,1325,643,1968,2623,39.971463,-79.0310021
01/01/2016 12:00:00 AM,42111,Southwest,Southern Alleghenies WDA,Somerset,56,45 to 64 Years,Female,10880,894,5080,1719,1205,1342,640,1982,3187,39.971463,-79.0310021
01/01/2014 12:00:00 AM,42111,Southwest,Southern Alleghenies WDA,Somerset,56,45 to 64 Years,Male,12273,1371,6643,1641,773,1213,632,1845,2618,39.971463,-79.0310021
01/01/2013 12:00:00 AM,42111,Southwest,Southern Alleghenies WDA,Somerset,56,45 to 64 Years,Male,12315,1443,6791,1528,754,1199,600,1799,2553,39.971463,-79.0310021
01/01/2012 12:00:00 AM,42111,Southwest,Southern Alleghenies WDA,Somerset,56,45 to 64 Years,Female,11207,1281,5418,1789,1017,1102,600,1702,2719,39.971463,-79.0310021
01/01/2015 12:00:00 AM,42111,Southwest,Southern Alleghenies WDA,Somerset,56,45 to 64 Years,Male,12335,1469,6642,1561,854,1234,575,1809,2663,39.971463,-79.0310021
01/01/2016 12:00:00 AM,42111,Southwest,Southern Alleghenies WDA,Somerset,56,45 to 64 Years,Male,12127,1292,6565,1629,901,1251,489,1740,2641,39.971463,-79.0310021
01/01/2016 12:00:00 AM,42111,Southwest,Southern Alleghenies WDA,Somerset,56,35 to 44 Years,Female,4126,378,1467,668,566,620,427,1047,1613,39.971463,-79.0310021
01/01/2015 12:00:00 AM,42111,Southwest,Southern Alleghenies WDA,Somerset,56,35 to 44 Years,Female,4204,366,1597,700,534,604,403,1007,1541,39.971463,-79.0310021
01/01/2013 12:00:00 AM,42111,Southwest,Southern Alleghenies WDA,Somerset,56,35 to 44 Years,Female,4473,348,1870,705,601,596,353,949,1550,39.971463,-79.0310021
01/01/2014 12:00:00 AM,42111,Southwest,Southern Alleghenies WDA,Somerset,56,35 to 44 Years,Female,4348,334,1802,732,522,606,352,958,1480,39.971463,-79.0310021
01/01/2014 12:00:00 AM,42111,Southwest,Southern Alleghenies WDA,Somerset,56,25 to 34 Years,Female,3669,417,1118,662,604,517,351,868,1472,39.971463,-79.0310021
01/01/2013 12:00:00 AM,42111,Southwest,Southern Alleghenies WDA,Somerset,56,25 to 34 Years,Female,3704,343,1189,641,702,493,336,829,1531,39.971463,-79.0310021
01/01/2011 12:00:00 AM,42111,Southwest,Southern Alleghenies WDA,Somerset,56,25 to 34 Years,Female,3782,374,1368,521,720,463,336,799,1519,39.971463,-79.0310021
01/01/2015 12:00:00 AM,42111,Southwest,Southern Alleghenies WDA,Somerset,56,25 to 34 Years,Female,3644,363,1160,734,588,479,320,799,1387,39.971463,-79.0310021
01/01/2010 12:00:00 AM,42111,Southwest,Southern Alleghenies WDA,Somerset,56,25 to 34 Years,Female,3784,336,1488,518,655,471,316,787,1442,39.971463,-79.0310021
01/01/2016 12:00:00 AM,42111,Southwest,Southern Alleghenies WDA,Somerset,56,25 to 34 Years,Female,3652,305,1242,737,524,535,309,844,1368,39.971463,-79.0310021
01/01/2012 12:00:00 AM,42111,Southwest,Southern Alleghenies WDA,Somerset,56,25 to 34 Years,Female,3701,361,1358,546,617,522,297,819,1436,39.971463,-79.0310021
01/01/2010 12:00:00 AM,42111,Southwest,Southern Alleghenies WDA,Somerset,56,35 to 44 Years,Male,5688,795,2980,782,336,499,296,795,1131,39.971463,-79.0310021
01/01/2012 12:00:00 AM,42111,Southwest,Southern Alleghenies WDA,Somerset,56,35 to 44 Years,Male,5549,492,2902,1012,396,479,268,747,1143,39.971463,-79.0310021
01/01/2011 12:00:00 AM,42111,Southwest,Southern Alleghenies WDA,Somerset,56,35 to 44 Years,Male,5575,603,2964,896,372,493,247,740,1112,39.971463,-79.0310021
01/01/2010 12:00:00 AM,42111,Southwest,Southern Alleghenies WDA,Somerset,56,35 to 44 Years,Female,4819,324,2197,779,693,580,246,826,1519,39.971463,-79.0310021
01/01/2011 12:00:00 AM,42111,Southwest,Southern Alleghenies WDA,Somerset,56,35 to 44 Years,Female,4681,309,2094,769,690,577,242,819,1509,39.971463,-79.0310021
01/01/2012 12:00:00 AM,42111,Southwest,Southern Alleghenies WDA,Somerset,56,35 to 44 Years,Female,4561,335,1957,795,681,551,242,793,1474,39.971463,-79.0310021
01/01/2015 12:00:00 AM,42111,Southwest,Southern Alleghenies WDA,Somerset,56,35 to 44 Years,Male,5299,497,2785,942,468,378,229,607,1075,39.971463,-79.0310021
01/01/2016 12:00:00 AM,42111,Southwest,Southern Alleghenies WDA,Somerset,56,35 to 44 Years,Male,5208,540,2746,888,444,363,227,590,1034,39.971463,-79.0310021
01/01/2014 12:00:00 AM,42111,Southwest,Southern Alleghenies WDA,Somerset,56,35 to 44 Years,Male,5410,541,2827,936,491,412,203,615,1106,39.971463,-79.0310021
01/01/2013 12:00:00 AM,42111,Southwest,Southern Alleghenies WDA,Somerset,56,35 to 44 Years,Male,5457,505,2882,981,408,490,191,681,1089,39.971463,-79.0310021
01/01/2012 12:00:00 AM,42111,Southwest,Southern Alleghenies WDA,Somerset,56,25 to 34 Years,Male,4820,748,2247,647,454,566,158,724,1178,39.971463,-79.0310021
01/01/2011 12:00:00 AM,42111,Southwest,Southern Alleghenies WDA,Somerset,56,25 to 34 Years,Male,4734,825,2218,585,416,540,150,690,1106,39.971463,-79.0310021
01/01/2010 12:00:00 AM,42111,Southwest,Southern Alleghenies WDA,Somerset,56,25 to 34 Years,Male,4952,821,2341,802,371,502,115,617,988,39.971463,-79.0310021
01/01/2014 12:00:00 AM,42111,Southwest,Southern Alleghenies WDA,Somerset,56,25 to 34 Years,Male,4926,570,2323,783,484,657,109,766,1250,39.971463,-79.0310021
01/01/2013 12:00:00 AM,42111,Southwest,Southern Alleghenies WDA,Somerset,56,25 to 34 Years,Male,4851,661,2344,659,467,619,101,720,1187,39.971463,-79.0310021
01/01/2015 12:00:00 AM,42111,Southwest,Southern Alleghenies WDA,Somerset,56,25 to 34 Years,Male,4903,598,2253,717,550,685,100,785,1335,39.971463,-79.0310021
01/01/2016 12:00:00 AM,42111,Southwest,Southern Alleghenies WDA,Somerset,56,25 to 34 Years,Male,4951,635,2363,670,539,646,98,744,1283,39.971463,-79.0310021
01/01/2010 12:00:00 AM,42055,Central,South Central WDA,Franklin,28,45 to 64 Years,Female,19901,2567,8950,3227,1547,1928,1682,3610,5157,39.927862,-77.7239884
01/01/2010 12:00:00 AM,42055,Central,South Central WDA,Franklin,28,45 to 64 Years,Male,18965,2664,8610,2700,1104,2228,1659,3887,4991,39.927862,-77.7239884
01/01/2011 12:00:00 AM,42055,Central,South Central WDA,Franklin,28,45 to 64 Years,Female,20127,2639,8823,3422,1519,2067,1657,3724,5243,39.927862,-77.7239884
01/01/2016 12:00:00 AM,42055,Central,South Central WDA,Franklin,28,45 to 64 Years,Female,20820,1914,9736,3250,1977,2376,1567,3943,5920,39.927862,-77.7239884
01/01/2012 12:00:00 AM,42055,Central,South Central WDA,Franklin,28,45 to 64 Years,Female,20327,2526,9253,3180,1643,2176,1549,3725,5368,39.927862,-77.7239884
01/01/2015 12:00:00 AM,42055,Central,South Central WDA,Franklin,28,45 to 64 Years,Female,20745,2186,9627,3223,1878,2296,1535,3831,5709,39.927862,-77.7239884
01/01/2012 12:00:00 AM,42055,Central,South Central WDA,Franklin,28,45 to 64 Years,Male,19612,2484,9176,2800,1232,2410,1510,3920,5152,39.927862,-77.7239884
01/01/2013 12:00:00 AM,42055,Central,South Central WDA,Franklin,28,45 to 64 Years,Male,19875,2654,9187,2928,1250,2356,1500,3856,5106,39.927862,-77.7239884
01/01/2011 12:00:00 AM,42055,Central,South Central WDA,Franklin,28,45 to 64 Years,Male,19423,2792,8746,2828,1152,2415,1490,3905,5057,39.927862,-77.7239884
01/01/2013 12:00:00 AM,42055,Central,South Central WDA,Franklin,28,45 to 64 Years,Female,20650,2465,9570,2992,1804,2359,1460,3819,5623,39.927862,-77.7239884
01/01/2014 12:00:00 AM,42055,Central,South Central WDA,Franklin,28,45 to 64 Years,Female,20694,2358,9454,3076,2016,2333,1457,3790,5806,39.927862,-77.7239884
01/01/2016 12:00:00 AM,42055,Central,South Central WDA,Franklin,28,45 to 64 Years,Male,20335,2857,9482,3056,1192,2414,1334,3748,4940,39.927862,-77.7239884
01/01/2015 12:00:00 AM,42055,Central,South Central WDA,Franklin,28,45 to 64 Years,Male,20226,2958,9648,3000,1104,2247,1269,3516,4620,39.927862,-77.7239884
01/01/2014 12:00:00 AM,42055,Central,South Central WDA,Franklin,28,45 to 64 Years,Male,20073,2806,9391,3211,1075,2338,1252,3590,4665,39.927862,-77.7239884
01/01/2016 12:00:00 AM,42055,Central,South Central WDA,Franklin,28,35 to 44 Years,Female,9516,778,2831,1782,1458,1587,1080,2667,4125,39.927862,-77.7239884
01/01/2015 12:00:00 AM,42055,Central,South Central WDA,Franklin,28,35 to 44 Years,Female,9574,769,3044,1748,1530,1472,1011,2483,4013,39.927862,-77.7239884
01/01/2014 12:00:00 AM,42055,Central,South Central WDA,Franklin,28,35 to 44 Years,Female,9616,679,3146,1950,1527,1368,946,2314,3841,39.927862,-77.7239884
01/01/2013 12:00:00 AM,42055,Central,South Central WDA,Franklin,28,35 to 44 Years,Female,9663,681,3191,1959,1371,1605,856,2461,3832,39.927862,-77.7239884
01/01/2012 12:00:00 AM,42055,Central,South Central WDA,Franklin,28,25 to 34 Years,Female,8589,1028,2303,1710,1045,1684,819,2503,3548,39.927862,-77.7239884
01/01/2013 12:00:00 AM,42055,Central,South Central WDA,Franklin,28,25 to 34 Years,Female,8869,1188,2544,1673,964,1701,799,2500,3464,39.927862,-77.7239884
01/01/2011 12:00:00 AM,42055,Central,South Central WDA,Franklin,28,25 to 34 Years,Female,8553,988,2678,1555,971,1600,761,2361,3332,39.927862,-77.7239884
01/01/2012 12:00:00 AM,42055,Central,South Central WDA,Franklin,28,35 to 44 Years,Female,9917,636,3602,1852,1344,1726,757,2483,3827,39.927862,-77.7239884
01/01/2010 12:00:00 AM,42055,Central,South Central WDA,Franklin,28,35 to 44 Years,Female,10031,652,3824,2060,1352,1437,706,2143,3495,39.927862,-77.7239884
01/01/2011 12:00:00 AM,42055,Central,South Central WDA,Franklin,28,35 to 44 Years,Female,9953,612,3682,1927,1278,1763,691,2454,3732,39.927862,-77.7239884
01/01/2014 12:00:00 AM,42055,Central,South Central WDA,Franklin,28,25 to 34 Years,Female,8856,1058,2459,1769,1001,1883,686,2569,3570,39.927862,-77.7239884
01/01/2010 12:00:00 AM,42055,Central,South Central WDA,Franklin,28,25 to 34 Years,Female,8481,1055,2672,1628,845,1605,676,2281,3126,39.927862,-77.7239884
01/01/2016 12:00:00 AM,42055,Central,South Central WDA,Franklin,28,25 to 34 Years,Female,9039,911,3053,1593,962,1887,633,2520,3482,39.927862,-77.7239884
01/01/2015 12:00:00 AM,42055,Central,South Central WDA,Franklin,28,25 to 34 Years,Female,9030,1007,2921,1656,935,1886,625,2511,3446,39.927862,-77.7239884
01/01/2013 12:00:00 AM,42055,Central,South Central WDA,Franklin,28,35 to 44 Years,Male,9820,1159,4823,1570,610,1082,576,1658,2268,39.927862,-77.7239884
01/01/2016 12:00:00 AM,42055,Central,South Central WDA,Franklin,28,35 to 44 Years,Male,9395,1130,4422,1515,787,975,566,1541,2328,39.927862,-77.7239884
01/01/2010 12:00:00 AM,42055,Central,South Central WDA,Franklin,28,35 to 44 Years,Male,10104,1146,4932,1547,620,1321,538,1859,2479,39.927862,-77.7239884
01/01/2011 12:00:00 AM,42055,Central,South Central WDA,Franklin,28,35 to 44 Years,Male,10110,1094,4969,1609,638,1295,505,1800,2438,39.927862,-77.7239884
01/01/2014 12:00:00 AM,42055,Central,South Central WDA,Franklin,28,35 to 44 Years,Male,9675,1106,4733,1631,644,1096,465,1561,2205,39.927862,-77.7239884
01/01/2012 12:00:00 AM,42055,Central,South Central WDA,Franklin,28,35 to 44 Years,Male,9870,1138,4848,1592,631,1206,455,1661,2292,39.927862,-77.7239884
01/01/2015 12:00:00 AM,42055,Central,South Central WDA,Franklin,28,35 to 44 Years,Male,9556,1143,4727,1583,684,1000,419,1419,2103,39.927862,-77.7239884
01/01/2015 12:00:00 AM,42055,Central,South Central WDA,Franklin,28,25 to 34 Years,Male,8768,882,3899,1606,783,1234,364,1598,2381,39.927862,-77.7239884
01/01/2013 12:00:00 AM,42055,Central,South Central WDA,Franklin,28,25 to 34 Years,Male,8521,1188,3311,1588,806,1279,349,1628,2434,39.927862,-77.7239884
01/01/2014 12:00:00 AM,42055,Central,South Central WDA,Franklin,28,25 to 34 Years,Male,8728,1159,3645,1548,807,1223,346,1569,2376,39.927862,-77.7239884
01/01/2016 12:00:00 AM,42055,Central,South Central WDA,Franklin,28,25 to 34 Years,Male,8837,1021,3739,1604,844,1303,326,1629,2473,39.927862,-77.7239884
01/01/2011 12:00:00 AM,42055,Central,South Central WDA,Franklin,28,25 to 34 Years,Male,8465,1393,3477,1477,782,1012,324,1336,2118,39.927862,-77.7239884
01/01/2010 12:00:00 AM,42055,Central,South Central WDA,Franklin,28,25 to 34 Years,Male,8486,1447,3449,1449,695,1136,310,1446,2141,39.927862,-77.7239884
01/01/2012 12:00:00 AM,42055,Central,South Central WDA,Franklin,28,25 to 34 Years,Male,8733,1387,3384,1635,825,1212,290,1502,2327,39.927862,-77.7239884
01/01/2013 12:00:00 AM,42057,Central,Southern Alleghenies WDA,Fulton,29,45 to 64 Years,Female,2118,214,1206,327,121,126,124,250,371,39.9248751,-78.1148505
01/01/2012 12:00:00 AM,42057,Central,Southern Alleghenies WDA,Fulton,29,45 to 64 Years,Female,2108,247,1132,330,153,126,120,246,399,39.9248751,-78.1148505
01/01/2016 12:00:00 AM,42057,Central,Southern Alleghenies WDA,Fulton,29,45 to 64 Years,Female,2100,187,1146,372,128,153,114,267,395,39.9248751,-78.1148505
01/01/2014 12:00:00 AM,42057,Central,Southern Alleghenies WDA,Fulton,29,45 to 64 Years,Female,2121,214,1173,354,109,159,112,271,380,39.9248751,-78.1148505
01/01/2011 12:00:00 AM,42057,Central,Southern Alleghenies WDA,Fulton,29,45 to 64 Years,Female,2096,306,1103,294,150,134,109,243,393,39.9248751,-78.1148505
01/01/2015 12:00:00 AM,42057,Central,Southern Alleghenies WDA,Fulton,29,45 to 64 Years,Female,2105,221,1167,337,123,150,107,257,380,39.9248751,-78.1148505
01/01/2010 12:00:00 AM,42057,Central,Southern Alleghenies WDA,Fulton,29,45 to 64 Years,Female,2042,291,1105,280,151,110,105,215,366,39.9248751,-78.1148505
01/01/2010 12:00:00 AM,42057,Central,Southern Alleghenies WDA,Fulton,29,45 to 64 Years,Male,2051,337,1093,303,74,141,103,244,318,39.9248751,-78.1148505
01/01/2014 12:00:00 AM,42057,Central,Southern Alleghenies WDA,Fulton,29,45 to 64 Years,Male,2113,296,1145,314,80,176,102,278,358,39.9248751,-78.1148505
01/01/2015 12:00:00 AM,42057,Central,Southern Alleghenies WDA,Fulton,29,45 to 64 Years,Male,2120,310,1184,279,96,165,86,251,347,39.9248751,-78.1148505
01/01/2016 12:00:00 AM,42057,Central,Southern Alleghenies WDA,Fulton,29,45 to 64 Years,Male,2136,261,1244,298,94,155,84,239,333,39.9248751,-78.1148505
01/01/2016 12:00:00 AM,42057,Central,Southern Alleghenies WDA,Fulton,29,35 to 44 Years,Female,860,86,325,156,108,101,84,185,293,39.9248751,-78.1148505
01/01/2011 12:00:00 AM,42057,Central,Southern Alleghenies WDA,Fulton,29,45 to 64 Years,Male,2063,350,1054,321,84,173,81,254,338,39.9248751,-78.1148505
01/01/2015 12:00:00 AM,42057,Central,Southern Alleghenies WDA,Fulton,29,35 to 44 Years,Female,887,90,320,181,112,103,81,184,296,39.9248751,-78.1148505
01/01/2013 12:00:00 AM,42057,Central,Southern Alleghenies WDA,Fulton,29,45 to 64 Years,Male,2095,325,1108,325,69,194,74,268,337,39.9248751,-78.1148505
01/01/2014 12:00:00 AM,42057,Central,Southern Alleghenies WDA,Fulton,29,35 to 44 Years,Female,910,91,361,153,128,106,71,177,305,39.9248751,-78.1148505
01/01/2015 12:00:00 AM,42057,Central,Southern Alleghenies WDA,Fulton,29,25 to 34 Years,Female,755,68,205,172,132,108,70,178,310,39.9248751,-78.1148505
01/01/2012 12:00:00 AM,42057,Central,Southern Alleghenies WDA,Fulton,29,45 to 64 Years,Male,2068,373,1052,326,83,167,67,234,317,39.9248751,-78.1148505
01/01/2013 12:00:00 AM,42057,Central,Southern Alleghenies WDA,Fulton,29,35 to 44 Years,Female,931,88,382,173,129,93,66,159,288,39.9248751,-78.1148505
01/01/2012 12:00:00 AM,42057,Central,Southern Alleghenies WDA,Fulton,29,25 to 34 Years,Female,780,60,324,159,121,61,55,116,237,39.9248751,-78.1148505
01/01/2016 12:00:00 AM,42057,Central,Southern Alleghenies WDA,Fulton,29,25 to 34 Years,Female,757,42,251,181,122,107,54,161,283,39.9248751,-78.1148505
01/01/2014 12:00:00 AM,42057,Central,Southern Alleghenies WDA,Fulton,29,25 to 34 Years,Female,757,70,265,162,122,84,54,138,260,39.9248751,-78.1148505
01/01/2013 12:00:00 AM,42057,Central,Southern Alleghenies WDA,Fulton,29,25 to 34 Years,Female,772,56,298,165,129,73,51,124,253,39.9248751,-78.1148505
01/01/2012 12:00:00 AM,42057,Central,Southern Alleghenies WDA,Fulton,29,35 to 44 Years,Female,947,71,437,195,103,93,48,141,244,39.9248751,-78.1148505
01/01/2011 12:00:00 AM,42057,Central,Southern Alleghenies WDA,Fulton,29,25 to 34 Years,Female,771,76,335,140,133,43,44,87,220,39.9248751,-78.1148505
01/01/2011 12:00:00 AM,42057,Central,Southern Alleghenies WDA,Fulton,29,35 to 44 Years,Female,970,54,523,186,82,95,30,125,207,39.9248751,-78.1148505
01/01/2010 12:00:00 AM,42057,Central,Southern Alleghenies WDA,Fulton,29,25 to 34 Years,Male,817,102,495,101,56,34,29,63,119,39.9248751,-78.1148505
01/01/2011 12:00:00 AM,42057,Central,Southern Alleghenies WDA,Fulton,29,25 to 34 Years,Male,811,90,482,104,59,48,28,76,135,39.9248751,-78.1148505
01/01/2010 12:00:00 AM,42057,Central,Southern Alleghenies WDA,Fulton,29,25 to 34 Years,Female,785,60,370,126,158,45,26,71,229,39.9248751,-78.1148505
01/01/2010 12:00:00 AM,42057,Central,Southern Alleghenies WDA,Fulton,29,35 to 44 Years,Female,983,43,560,156,91,109,24,133,224,39.9248751,-78.1148505
01/01/2011 12:00:00 AM,42057,Central,Southern Alleghenies WDA,Fulton,29,35 to 44 Years,Male,1103,84,677,168,77,74,23,97,174,39.9248751,-78.1148505
01/01/2012 12:00:00 AM,42057,Central,Southern Alleghenies WDA,Fulton,29,35 to 44 Years,Male,1066,72,638,166,81,88,21,109,190,39.9248751,-78.1148505
01/01/2015 12:00:00 AM,42057,Central,Southern Alleghenies WDA,Fulton,29,35 to 44 Years,Male,963,87,556,142,72,85,21,106,178,39.9248751,-78.1148505
01/01/2013 12:00:00 AM,42057,Central,Southern Alleghenies WDA,Fulton,29,35 to 44 Years,Male,1038,59,602,189,78,90,20,110,188,39.9248751,-78.1148505
01/01/2016 12:00:00 AM,42057,Central,Southern Alleghenies WDA,Fulton,29,35 to 44 Years,Male,914,72,530,141,79,74,18,92,171,39.9248751,-78.1148505
01/01/2014 12:00:00 AM,42057,Central,Southern Alleghenies WDA,Fulton,29,35 to 44 Years,Male,994,73,612,149,69,73,18,91,160,39.9248751,-78.1148505
01/01/2012 12:00:00 AM,42057,Central,Southern Alleghenies WDA,Fulton,29,25 to 34 Years,Male,830,83,496,119,59,55,18,73,132,39.9248751,-78.1148505
01/01/2010 12:00:00 AM,42057,Central,Southern Alleghenies WDA,Fulton,29,35 to 44 Years,Male,1108,68,713,167,81,62,17,79,160,39.9248751,-78.1148505
01/01/2016 12:00:00 AM,42057,Central,Southern Alleghenies WDA,Fulton,29,25 to 34 Years,Male,790,66,470,99,58,82,15,97,155,39.9248751,-78.1148505
01/01/2013 12:00:00 AM,42057,Central,Southern Alleghenies WDA,Fulton,29,25 to 34 Years,Male,812,75,478,101,71,72,15,87,158,39.9248751,-78.1148505
01/01/2014 12:00:00 AM,42057,Central,Southern Alleghenies WDA,Fulton,29,25 to 34 Years,Male,802,85,460,113,65,64,15,79,144,39.9248751,-78.1148505
01/01/2015 12:00:00 AM,42057,Central,Southern Alleghenies WDA,Fulton,29,25 to 34 Years,Male,799,86,441,116,71,73,12,85,156,39.9248751,-78.1148505
01/01/2015 12:00:00 AM,42133,Central,South Central WDA,York,67,45 to 64 Years,Male,62531,6259,27289,10467,4416,8697,5403,14100,18516,39.9219253,-76.7257605
01/01/2014 12:00:00 AM,42133,Central,South Central WDA,York,67,45 to 64 Years,Female,63936,5057,28384,10761,5590,8879,5265,14144,19734,39.9219253,-76.7257605
01/01/2014 12:00:00 AM,42133,Central,South Central WDA,York,67,45 to 64 Years,Male,62367,6168,27440,10280,4670,8567,5242,13809,18479,39.9219253,-76.7257605
01/01/2016 12:00:00 AM,42133,Central,South Central WDA,York,67,45 to 64 Years,Male,62495,6236,27467,10316,4601,8650,5225,13875,18476,39.9219253,-76.7257605
01/01/2012 12:00:00 AM,42133,Central,South Central WDA,York,67,45 to 64 Years,Female,62980,4947,29006,10215,5585,8080,5147,13227,18812,39.9219253,-76.7257605
01/01/2013 12:00:00 AM,42133,Central,South Central WDA,York,67,45 to 64 Years,Female,63639,4956,28665,10825,5518,8535,5140,13675,19193,39.9219253,-76.7257605
01/01/2015 12:00:00 AM,42133,Central,South Central WDA,York,67,45 to 64 Years,Female,64005,5098,27743,10708,6144,9242,5070,14312,20456,39.9219253,-76.7257605
01/01/2016 12:00:00 AM,42133,Central,South Central WDA,York,67,45 to 64 Years,Female,63943,5016,27387,10798,6429,9248,5065,14313,20742,39.9219253,-76.7257605
01/01/2013 12:00:00 AM,42133,Central,South Central WDA,York,67,45 to 64 Years,Male,61968,5934,27753,10662,4638,7978,5003,12981,17619,39.9219253,-76.7257605
01/01/2011 12:00:00 AM,42133,Central,South Central WDA,York,67,45 to 64 Years,Female,62127,5330,28617,9706,5509,7985,4980,12965,18474,39.9219253,-76.7257605
01/01/2010 12:00:00 AM,42133,Central,South Central WDA,York,67,45 to 64 Years,Male,59440,5874,25574,9969,4393,8701,4929,13630,18023,39.9219253,-76.7257605
01/01/2012 12:00:00 AM,42133,Central,South Central WDA,York,67,45 to 64 Years,Male,61441,6060,27045,10521,4592,8296,4927,13223,17815,39.9219253,-76.7257605
01/01/2011 12:00:00 AM,42133,Central,South Central WDA,York,67,45 to 64 Years,Male,60626,5915,26497,10014,4436,8872,4892,13764,18200,39.9219253,-76.7257605
01/01/2010 12:00:00 AM,42133,Central,South Central WDA,York,67,45 to 64 Years,Female,60864,5752,28050,9591,5327,7291,4853,12144,17471,39.9219253,-76.7257605
01/01/2016 12:00:00 AM,42133,Central,South Central WDA,York,67,35 to 44 Years,Female,27873,1882,8425,5111,3474,5731,3250,8981,12455,39.9219253,-76.7257605
01/01/2015 12:00:00 AM,42133,Central,South Central WDA,York,67,35 to 44 Years,Female,28388,1966,8834,5194,3756,5430,3208,8638,12394,39.9219253,-76.7257605
01/01/2014 12:00:00 AM,42133,Central,South Central WDA,York,67,35 to 44 Years,Female,28982,1962,9321,5008,3834,5721,3136,8857,12691,39.9219253,-76.7257605
01/01/2013 12:00:00 AM,42133,Central,South Central WDA,York,67,35 to 44 Years,Female,29479,2124,9760,5203,3681,5984,2727,8711,12392,39.9219253,-76.7257605
01/01/2016 12:00:00 AM,42133,Central,South Central WDA,York,67,25 to 34 Years,Female,26497,2038,7627,4659,3073,6541,2559,9100,12173,39.9219253,-76.7257605
01/01/2012 12:00:00 AM,42133,Central,South Central WDA,York,67,35 to 44 Years,Female,30228,2138,10368,5632,3752,5796,2542,8338,12090,39.9219253,-76.7257605
01/01/2011 12:00:00 AM,42133,Central,South Central WDA,York,67,35 to 44 Years,Female,30911,2159,11120,5792,3615,5754,2471,8225,11840,39.9219253,-76.7257605
01/01/2010 12:00:00 AM,42133,Central,South Central WDA,York,67,35 to 44 Years,Female,31389,2459,11386,5744,3409,5924,2467,8391,11800,39.9219253,-76.7257605
01/01/2016 12:00:00 AM,42133,Central,South Central WDA,York,67,35 to 44 Years,Male,27357,2665,10405,4950,2405,4547,2385,6932,9337,39.9219253,-76.7257605
01/01/2014 12:00:00 AM,42133,Central,South Central WDA,York,67,25 to 34 Years,Female,25929,1990,7550,4916,2902,6217,2354,8571,11473,39.9219253,-76.7257605
01/01/2012 12:00:00 AM,42133,Central,South Central WDA,York,67,25 to 34 Years,Female,25532,1857,7453,5178,3007,5704,2333,8037,11044,39.9219253,-76.7257605
01/01/2010 12:00:00 AM,42133,Central,South Central WDA,York,67,35 to 44 Years,Male,31269,3166,13337,4936,2388,5152,2290,7442,9830,39.9219253,-76.7257605
01/01/2013 12:00:00 AM,42133,Central,South Central WDA,York,67,35 to 44 Years,Male,29214,2656,11897,5213,2150,5008,2290,7298,9448,39.9219253,-76.7257605
01/01/2012 12:00:00 AM,42133,Central,South Central WDA,York,67,35 to 44 Years,Male,29984,2798,12383,5273,2305,4938,2287,7225,9530,39.9219253,-76.7257605
01/01/2015 12:00:00 AM,42133,Central,South Central WDA,York,67,25 to 34 Years,Female,26249,2027,7798,4441,3060,6663,2260,8923,11983,39.9219253,-76.7257605
01/01/2010 12:00:00 AM,42133,Central,South Central WDA,York,67,25 to 34 Years,Female,25169,1895,7556,5006,2945,5515,2252,7767,10712,39.9219253,-76.7257605
01/01/2011 12:00:00 AM,42133,Central,South Central WDA,York,67,35 to 44 Years,Male,30703,2819,12902,5251,2435,5051,2245,7296,9731,39.9219253,-76.7257605
01/01/2011 12:00:00 AM,42133,Central,South Central WDA,York,67,25 to 34 Years,Female,25357,1912,7579,5153,3027,5462,2224,7686,10713,39.9219253,-76.7257605
01/01/2013 12:00:00 AM,42133,Central,South Central WDA,York,67,25 to 34 Years,Female,25697,1784,7410,5303,2967,6017,2216,8233,11200,39.9219253,-76.7257605
01/01/2015 12:00:00 AM,42133,Central,South Central WDA,York,67,35 to 44 Years,Male,27953,2577,11068,5127,2475,4491,2215,6706,9181,39.9219253,-76.7257605
01/01/2014 12:00:00 AM,42133,Central,South Central WDA,York,67,35 to 44 Years,Male,28540,2748,11248,5217,2409,4740,2178,6918,9327,39.9219253,-76.7257605
01/01/2014 12:00:00 AM,42133,Central,South Central WDA,York,67,25 to 34 Years,Male,25702,2517,9886,4816,2442,4611,1430,6041,8483,39.9219253,-76.7257605
01/01/2015 12:00:00 AM,42133,Central,South Central WDA,York,67,25 to 34 Years,Male,26127,2653,10325,4699,2310,4768,1372,6140,8450,39.9219253,-76.7257605
01/01/2013 12:00:00 AM,42133,Central,South Central WDA,York,67,25 to 34 Years,Male,25327,2671,9719,4752,2355,4512,1318,5830,8185,39.9219253,-76.7257605
01/01/2016 12:00:00 AM,42133,Central,South Central WDA,York,67,25 to 34 Years,Male,26561,2726,10344,4859,2295,5092,1245,6337,8632,39.9219253,-76.7257605
01/01/2012 12:00:00 AM,42133,Central,South Central WDA,York,67,25 to 34 Years,Male,25058,2707,9788,4615,2444,4283,1221,5504,7948,39.9219253,-76.7257605
01/01/2011 12:00:00 AM,42133,Central,South Central WDA,York,67,25 to 34 Years,Male,24807,2611,9993,4397,2459,4162,1185,5347,7806,39.9219253,-76.7257605
01/01/2010 12:00:00 AM,42133,Central,South Central WDA,York,67,25 to 34 Years,Male,24530,2685,9621,4543,2530,4076,1075,5151,7681,39.9219253,-76.7257605
01/01/2010 12:00:00 AM,42051,Southwest,Westmoreland-Fayette Counties WDA,Fayette,26,45 to 64 Years,Female,20378,2519,10420,2541,1865,1914,1119,3033,4898,39.9194478,-79.6518963
01/01/2016 12:00:00 AM,42051,Southwest,Westmoreland-Fayette Counties WDA,Fayette,26,45 to 64 Years,Female,20199,1765,10351,2826,2294,1851,1112,2963,5257,39.9194478,-79.6518963
01/01/2010 12:00:00 AM,42051,Southwest,Westmoreland-Fayette Counties WDA,Fayette,26,45 to 64 Years,Male,20078,2931,10507,2435,1306,1805,1094,2899,4205,39.9194478,-79.6518963
01/01/2011 12:00:00 AM,42051,Southwest,Westmoreland-Fayette Counties WDA,Fayette,26,45 to 64 Years,Female,20455,2502,10306,2714,1895,1968,1070,3038,4933,39.9194478,-79.6518963
01/01/2012 12:00:00 AM,42051,Southwest,Westmoreland-Fayette Counties WDA,Fayette,26,45 to 64 Years,Female,20504,2430,10401,2760,1881,1984,1048,3032,4913,39.9194478,-79.6518963
01/01/2011 12:00:00 AM,42051,Southwest,Westmoreland-Fayette Counties WDA,Fayette,26,45 to 64 Years,Male,20292,3023,10671,2470,1404,1676,1048,2724,4128,39.9194478,-79.6518963
01/01/2015 12:00:00 AM,42051,Southwest,Westmoreland-Fayette Counties WDA,Fayette,26,45 to 64 Years,Female,20392,1798,10388,3068,2292,1808,1038,2846,5138,39.9194478,-79.6518963
01/01/2012 12:00:00 AM,42051,Southwest,Westmoreland-Fayette Counties WDA,Fayette,26,45 to 64 Years,Male,20367,2948,10684,2486,1549,1688,1012,2700,4249,39.9194478,-79.6518963
01/01/2013 12:00:00 AM,42051,Southwest,Westmoreland-Fayette Counties WDA,Fayette,26,45 to 64 Years,Female,20494,2319,10485,2902,1956,1842,990,2832,4788,39.9194478,-79.6518963
01/01/2014 12:00:00 AM,42051,Southwest,Westmoreland-Fayette Counties WDA,Fayette,26,45 to 64 Years,Female,20475,2179,10132,3177,2090,1936,961,2897,4987,39.9194478,-79.6518963
01/01/2013 12:00:00 AM,42051,Southwest,Westmoreland-Fayette Counties WDA,Fayette,26,45 to 64 Years,Male,20432,2725,10640,2620,1805,1757,885,2642,4447,39.9194478,-79.6518963
01/01/2014 12:00:00 AM,42051,Southwest,Westmoreland-Fayette Counties WDA,Fayette,26,45 to 64 Years,Male,20290,2585,10662,2700,1754,1745,844,2589,4343,39.9194478,-79.6518963
01/01/2016 12:00:00 AM,42051,Southwest,Westmoreland-Fayette Counties WDA,Fayette,26,45 to 64 Years,Male,19982,2254,10871,2393,1877,1762,825,2587,4464,39.9194478,-79.6518963
01/01/2015 12:00:00 AM,42051,Southwest,Westmoreland-Fayette Counties WDA,Fayette,26,45 to 64 Years,Male,20172,2562,10909,2378,1876,1693,754,2447,4323,39.9194478,-79.6518963
01/01/2015 12:00:00 AM,42051,Southwest,Westmoreland-Fayette Counties WDA,Fayette,26,35 to 44 Years,Female,8177,622,3341,1403,1162,1098,551,1649,2811,39.9194478,-79.6518963
01/01/2012 12:00:00 AM,42051,Southwest,Westmoreland-Fayette Counties WDA,Fayette,26,35 to 44 Years,Female,8882,656,3725,1729,1212,1010,550,1560,2772,39.9194478,-79.6518963
01/01/2013 12:00:00 AM,42051,Southwest,Westmoreland-Fayette Counties WDA,Fayette,26,35 to 44 Years,Female,8599,569,3550,1808,1159,1002,511,1513,2672,39.9194478,-79.6518963
01/01/2010 12:00:00 AM,42051,Southwest,Westmoreland-Fayette Counties WDA,Fayette,26,35 to 44 Years,Male,9269,1101,4705,1455,747,780,481,1261,2008,39.9194478,-79.6518963
01/01/2016 12:00:00 AM,42051,Southwest,Westmoreland-Fayette Counties WDA,Fayette,26,35 to 44 Years,Female,8034,573,3273,1271,1151,1286,480,1766,2917,39.9194478,-79.6518963
01/01/2011 12:00:00 AM,42051,Southwest,Westmoreland-Fayette Counties WDA,Fayette,26,35 to 44 Years,Female,9135,717,3870,1751,1210,1118,469,1587,2797,39.9194478,-79.6518963
01/01/2014 12:00:00 AM,42051,Southwest,Westmoreland-Fayette Counties WDA,Fayette,26,35 to 44 Years,Female,8368,600,3644,1548,1125,984,467,1451,2576,39.9194478,-79.6518963
01/01/2015 12:00:00 AM,42051,Southwest,Westmoreland-Fayette Counties WDA,Fayette,26,25 to 34 Years,Female,7177,585,2212,1480,1320,1134,446,1580,2900,39.9194478,-79.6518963
01/01/2011 12:00:00 AM,42051,Southwest,Westmoreland-Fayette Counties WDA,Fayette,26,25 to 34 Years,Female,7482,891,2362,1292,1017,1481,439,1920,2937,39.9194478,-79.6518963
01/01/2010 12:00:00 AM,42051,Southwest,Westmoreland-Fayette Counties WDA,Fayette,26,25 to 34 Years,Female,7516,890,2379,1321,974,1514,438,1952,2926,39.9194478,-79.6518963
01/01/2016 12:00:00 AM,42051,Southwest,Westmoreland-Fayette Counties WDA,Fayette,26,25 to 34 Years,Female,7112,581,2272,1410,1306,1110,433,1543,2849,39.9194478,-79.6518963
01/01/2013 12:00:00 AM,42051,Southwest,Westmoreland-Fayette Counties WDA,Fayette,26,25 to 34 Years,Female,7248,697,2262,1323,1081,1458,427,1885,2966,39.9194478,-79.6518963
01/01/2014 12:00:00 AM,42051,Southwest,Westmoreland-Fayette Counties WDA,Fayette,26,25 to 34 Years,Female,7182,719,2277,1304,1176,1288,418,1706,2882,39.9194478,-79.6518963
01/01/2012 12:00:00 AM,42051,Southwest,Westmoreland-Fayette Counties WDA,Fayette,26,25 to 34 Years,Female,7369,828,2226,1415,1100,1390,410,1800,2900,39.9194478,-79.6518963
01/01/2012 12:00:00 AM,42051,Southwest,Westmoreland-Fayette Counties WDA,Fayette,26,35 to 44 Years,Male,8903,962,4435,1518,770,824,394,1218,1988,39.9194478,-79.6518963
01/01/2011 12:00:00 AM,42051,Southwest,Westmoreland-Fayette Counties WDA,Fayette,26,35 to 44 Years,Male,9122,1015,4636,1497,811,791,372,1163,1974,39.9194478,-79.6518963
01/01/2010 12:00:00 AM,42051,Southwest,Westmoreland-Fayette Counties WDA,Fayette,26,35 to 44 Years,Female,9396,879,4243,1745,1022,1139,368,1507,2529,39.9194478,-79.6518963
01/01/2012 12:00:00 AM,42051,Southwest,Westmoreland-Fayette Counties WDA,Fayette,26,25 to 34 Years,Male,7793,1028,3580,1332,449,1109,295,1404,1853,39.9194478,-79.6518963
01/01/2010 12:00:00 AM,42051,Southwest,Westmoreland-Fayette Counties WDA,Fayette,26,25 to 34 Years,Male,7896,1043,3511,1490,592,973,287,1260,1852,39.9194478,-79.6518963
01/01/2015 12:00:00 AM,42051,Southwest,Westmoreland-Fayette Counties WDA,Fayette,26,35 to 44 Years,Male,8264,809,4014,1331,876,948,286,1234,2110,39.9194478,-79.6518963
01/01/2013 12:00:00 AM,42051,Southwest,Westmoreland-Fayette Counties WDA,Fayette,26,35 to 44 Years,Male,8753,894,4367,1572,766,875,279,1154,1920,39.9194478,-79.6518963
01/01/2016 12:00:00 AM,42051,Southwest,Westmoreland-Fayette Counties WDA,Fayette,26,35 to 44 Years,Male,8117,853,3971,1344,718,957,274,1231,1949,39.9194478,-79.6518963
01/01/2014 12:00:00 AM,42051,Southwest,Westmoreland-Fayette Counties WDA,Fayette,26,35 to 44 Years,Male,8629,807,4416,1406,874,867,259,1126,2000,39.9194478,-79.6518963
01/01/2011 12:00:00 AM,42051,Southwest,Westmoreland-Fayette Counties WDA,Fayette,26,25 to 34 Years,Male,7795,1124,3563,1350,447,1057,254,1311,1758,39.9194478,-79.6518963
01/01/2014 12:00:00 AM,42051,Southwest,Westmoreland-Fayette Counties WDA,Fayette,26,25 to 34 Years,Male,7940,827,3830,1324,558,1192,209,1401,1959,39.9194478,-79.6518963
01/01/2016 12:00:00 AM,42051,Southwest,Westmoreland-Fayette Counties WDA,Fayette,26,25 to 34 Years,Male,8058,788,4133,1160,744,1044,189,1233,1977,39.9194478,-79.6518963
01/01/2015 12:00:00 AM,42051,Southwest,Westmoreland-Fayette Counties WDA,Fayette,26,25 to 34 Years,Male,8125,786,4108,1330,616,1097,188,1285,1901,39.9194478,-79.6518963
01/01/2013 12:00:00 AM,42051,Southwest,Westmoreland-Fayette Counties WDA,Fayette,26,25 to 34 Years,Male,7864,937,3721,1291,553,1181,181,1362,1915,39.9194478,-79.6518963
01/01/2016 12:00:00 AM,42045,Southeast,Delaware County WDA,Delaware,23,45 to 64 Years,Female,81050,4614,25682,13798,7590,16265,13101,29366,36956,39.9165787,-75.4062771
01/01/2010 12:00:00 AM,42045,Southeast,Delaware County WDA,Delaware,23,45 to 64 Years,Male,71076,5160,22242,11717,4537,14593,12827,27420,31957,39.9165787,-75.4062771
01/01/2011 12:00:00 AM,42045,Southeast,Delaware County WDA,Delaware,23,45 to 64 Years,Male,72257,4975,22989,12529,4467,14828,12469,27297,31764,39.9165787,-75.4062771
01/01/2013 12:00:00 AM,42045,Southeast,Delaware County WDA,Delaware,23,45 to 64 Years,Female,80673,4596,27001,13849,7242,15542,12443,27985,35227,39.9165787,-75.4062771
01/01/2012 12:00:00 AM,42045,Southeast,Delaware County WDA,Delaware,23,45 to 64 Years,Male,73047,4692,23603,12644,4640,15051,12417,27468,32108,39.9165787,-75.4062771
01/01/2012 12:00:00 AM,42045,Southeast,Delaware County WDA,Delaware,23,45 to 64 Years,Female,80010,4710,27092,14209,6970,14723,12306,27029,33999,39.9165787,-75.4062771
01/01/2010 12:00:00 AM,42045,Southeast,Delaware County WDA,Delaware,23,45 to 64 Years,Female,77725,5541,26069,13255,6722,13870,12268,26138,32860,39.9165787,-75.4062771
01/01/2015 12:00:00 AM,42045,Southeast,Delaware County WDA,Delaware,23,45 to 64 Years,Female,81264,4767,26504,13765,7644,16317,12267,28584,36228,39.9165787,-75.4062771
01/01/2011 12:00:00 AM,42045,Southeast,Delaware County WDA,Delaware,23,45 to 64 Years,Female,79134,5158,26695,14096,6827,14262,12096,26358,33185,39.9165787,-75.4062771
01/01/2014 12:00:00 AM,42045,Southeast,Delaware County WDA,Delaware,23,45 to 64 Years,Female,81094,4683,27405,13604,6951,16357,12094,28451,35402,39.9165787,-75.4062771
01/01/2013 12:00:00 AM,42045,Southeast,Delaware County WDA,Delaware,23,45 to 64 Years,Male,73699,4624,24369,12824,4732,15113,12037,27150,31882,39.9165787,-75.4062771
01/01/2016 12:00:00 AM,42045,Southeast,Delaware County WDA,Delaware,23,45 to 64 Years,Male,73931,5127,24803,12515,4489,15121,11876,26997,31486,39.9165787,-75.4062771
01/01/2014 12:00:00 AM,42045,Southeast,Delaware County WDA,Delaware,23,45 to 64 Years,Male,74131,4808,24529,12993,4808,15353,11640,26993,31801,39.9165787,-75.4062771
01/01/2015 12:00:00 AM,42045,Southeast,Delaware County WDA,Delaware,23,45 to 64 Years,Male,74207,5008,24930,12720,4568,15472,11509,26981,31549,39.9165787,-75.4062771
01/01/2015 12:00:00 AM,42045,Southeast,Delaware County WDA,Delaware,23,35 to 44 Years,Female,34852,1644,7846,6076,3362,9032,6892,15924,19286,39.9165787,-75.4062771
01/01/2016 12:00:00 AM,42045,Southeast,Delaware County WDA,Delaware,23,35 to 44 Years,Female,34506,1624,7701,5715,3443,9191,6832,16023,19466,39.9165787,-75.4062771
01/01/2014 12:00:00 AM,42045,Southeast,Delaware County WDA,Delaware,23,35 to 44 Years,Female,35095,1672,7960,6354,3351,9255,6503,15758,19109,39.9165787,-75.4062771
01/01/2013 12:00:00 AM,42045,Southeast,Delaware County WDA,Delaware,23,35 to 44 Years,Female,35526,1659,8355,6423,3705,9112,6272,15384,19089,39.9165787,-75.4062771
01/01/2012 12:00:00 AM,42045,Southeast,Delaware County WDA,Delaware,23,35 to 44 Years,Female,36215,1699,8550,6781,3832,9192,6161,15353,19185,39.9165787,-75.4062771
01/01/2010 12:00:00 AM,42045,Southeast,Delaware County WDA,Delaware,23,35 to 44 Years,Female,38152,1915,9705,6988,3863,9682,5999,15681,19544,39.9165787,-75.4062771
01/01/2011 12:00:00 AM,42045,Southeast,Delaware County WDA,Delaware,23,35 to 44 Years,Female,37169,1930,9122,6847,3812,9525,5933,15458,19270,39.9165787,-75.4062771
01/01/2015 12:00:00 AM,42045,Southeast,Delaware County WDA,Delaware,23,35 to 44 Years,Male,32194,2286,9726,5170,2334,6788,5890,12678,15012,39.9165787,-75.4062771
01/01/2014 12:00:00 AM,42045,Southeast,Delaware County WDA,Delaware,23,35 to 44 Years,Male,32500,2609,9286,5208,2603,6950,5844,12794,15397,39.9165787,-75.4062771
01/01/2015 12:00:00 AM,42045,Southeast,Delaware County WDA,Delaware,23,25 to 34 Years,Female,35965,1890,7053,6926,3336,11034,5726,16760,20096,39.9165787,-75.4062771
01/01/2016 12:00:00 AM,42045,Southeast,Delaware County WDA,Delaware,23,25 to 34 Years,Female,36336,1806,7296,6691,3547,11278,5718,16996,20543,39.9165787,-75.4062771
01/01/2016 12:00:00 AM,42045,Southeast,Delaware County WDA,Delaware,23,35 to 44 Years,Male,32040,2349,9360,4990,2082,7541,5718,13259,15341,39.9165787,-75.4062771
01/01/2012 12:00:00 AM,42045,Southeast,Delaware County WDA,Delaware,23,35 to 44 Years,Male,33632,2678,9265,5606,2694,7714,5675,13389,16083,39.9165787,-75.4062771
01/01/2013 12:00:00 AM,42045,Southeast,Delaware County WDA,Delaware,23,35 to 44 Years,Male,32981,2511,9649,5153,2777,7248,5643,12891,15668,39.9165787,-75.4062771
01/01/2011 12:00:00 AM,42045,Southeast,Delaware County WDA,Delaware,23,35 to 44 Years,Male,34495,2602,9838,5840,2821,7787,5607,13394,16215,39.9165787,-75.4062771
01/01/2010 12:00:00 AM,42045,Southeast,Delaware County WDA,Delaware,23,35 to 44 Years,Male,35408,2762,10279,5976,2815,8071,5505,13576,16391,39.9165787,-75.4062771
01/01/2014 12:00:00 AM,42045,Southeast,Delaware County WDA,Delaware,23,25 to 34 Years,Female,35461,2014,7265,6913,3323,10690,5256,15946,19269,39.9165787,-75.4062771
01/01/2010 12:00:00 AM,42045,Southeast,Delaware County WDA,Delaware,23,25 to 34 Years,Female,33693,1633,7330,6009,3055,10439,5227,15666,18721,39.9165787,-75.4062771
01/01/2011 12:00:00 AM,42045,Southeast,Delaware County WDA,Delaware,23,25 to 34 Years,Female,33969,1685,7134,6293,3056,10610,5191,15801,18857,39.9165787,-75.4062771
01/01/2012 12:00:00 AM,42045,Southeast,Delaware County WDA,Delaware,23,25 to 34 Years,Female,34468,1859,7122,6696,3187,10704,4900,15604,18791,39.9165787,-75.4062771
01/01/2013 12:00:00 AM,42045,Southeast,Delaware County WDA,Delaware,23,25 to 34 Years,Female,34954,1943,7242,6920,3318,10631,4900,15531,18849,39.9165787,-75.4062771
01/01/2010 12:00:00 AM,42045,Southeast,Delaware County WDA,Delaware,23,25 to 34 Years,Male,31721,2306,8929,6515,2390,8158,3423,11581,13971,39.9165787,-75.4062771
01/01/2011 12:00:00 AM,42045,Southeast,Delaware County WDA,Delaware,23,25 to 34 Years,Male,32130,2301,8964,7196,2569,7854,3246,11100,13669,39.9165787,-75.4062771
01/01/2016 12:00:00 AM,42045,Southeast,Delaware County WDA,Delaware,23,25 to 34 Years,Male,35151,2645,9748,7397,3018,9191,3152,12343,15361,39.9165787,-75.4062771
01/01/2014 12:00:00 AM,42045,Southeast,Delaware County WDA,Delaware,23,25 to 34 Years,Male,33973,2399,9381,7528,3053,8496,3116,11612,14665,39.9165787,-75.4062771
01/01/2013 12:00:00 AM,42045,Southeast,Delaware County WDA,Delaware,23,25 to 34 Years,Male,33327,2292,9458,7556,2907,8091,3023,11114,14021,39.9165787,-75.4062771
01/01/2015 12:00:00 AM,42045,Southeast,Delaware County WDA,Delaware,23,25 to 34 Years,Male,34581,2543,9430,7408,3072,9107,3021,12128,15200,39.9165787,-75.4062771
01/01/2012 12:00:00 AM,42045,Southeast,Delaware County WDA,Delaware,23,25 to 34 Years,Male,32656,2165,9180,7470,2861,8067,2913,10980,13841,39.9165787,-75.4062771
01/01/2014 12:00:00 AM,42001,Central,South Central WDA,Adams,1,45 to 64 Years,Female,15241,1269,6564,2495,1237,2127,1549,3676,4913,39.8720957,-77.2222427
01/01/2015 12:00:00 AM,42001,Central,South Central WDA,Adams,1,45 to 64 Years,Female,15202,1138,6611,2550,1253,2107,1543,3650,4903,39.8720957,-77.2222427
01/01/2013 12:00:00 AM,42001,Central,South Central WDA,Adams,1,45 to 64 Years,Female,15043,1292,6486,2637,1286,1919,1423,3342,4628,39.8720957,-77.2222427
01/01/2016 12:00:00 AM,42001,Central,South Central WDA,Adams,1,45 to 64 Years,Female,15142,1116,6561,2623,1365,2077,1400,3477,4842,39.8720957,-77.2222427
01/01/2015 12:00:00 AM,42001,Central,South Central WDA,Adams,1,45 to 64 Years,Male,14751,1753,6751,2171,1058,1689,1329,3018,4076,39.8720957,-77.2222427
01/01/2016 12:00:00 AM,42001,Central,South Central WDA,Adams,1,45 to 64 Years,Male,14775,1754,6807,2125,1088,1684,1317,3001,4089,39.8720957,-77.2222427
01/01/2014 12:00:00 AM,42001,Central,South Central WDA,Adams,1,45 to 64 Years,Male,14755,1715,6841,2134,1084,1674,1307,2981,4065,39.8720957,-77.2222427
01/01/2013 12:00:00 AM,42001,Central,South Central WDA,Adams,1,45 to 64 Years,Male,14637,1828,6635,2270,1028,1610,1266,2876,3904,39.8720957,-77.2222427
01/01/2012 12:00:00 AM,42001,Central,South Central WDA,Adams,1,45 to 64 Years,Female,14828,1400,6443,2719,1133,1906,1227,3133,4266,39.8720957,-77.2222427
01/01/2012 12:00:00 AM,42001,Central,South Central WDA,Adams,1,45 to 64 Years,Male,14432,1776,6452,2392,935,1696,1181,2877,3812,39.8720957,-77.2222427
01/01/2011 12:00:00 AM,42001,Central,South Central WDA,Adams,1,45 to 64 Years,Female,14562,1391,6699,2419,1126,1810,1117,2927,4053,39.8720957,-77.2222427
01/01/2011 12:00:00 AM,42001,Central,South Central WDA,Adams,1,45 to 64 Years,Male,14325,1822,6459,2313,932,1691,1108,2799,3731,39.8720957,-77.2222427
01/01/2010 12:00:00 AM,42001,Central,South Central WDA,Adams,1,45 to 64 Years,Male,13951,1888,6175,2225,889,1708,1066,2774,3663,39.8720957,-77.2222427
01/01/2010 12:00:00 AM,42001,Central,South Central WDA,Adams,1,45 to 64 Years,Female,14294,1341,6841,2274,1110,1736,992,2728,3838,39.8720957,-77.2222427
01/01/2016 12:00:00 AM,42001,Central,South Central WDA,Adams,1,35 to 44 Years,Female,5812,416,1875,1073,788,887,773,1660,2448,39.8720957,-77.2222427
01/01/2015 12:00:00 AM,42001,Central,South Central WDA,Adams,1,35 to 44 Years,Female,6019,520,2000,1084,791,931,693,1624,2415,39.8720957,-77.2222427
01/01/2014 12:00:00 AM,42001,Central,South Central WDA,Adams,1,35 to 44 Years,Female,6205,548,2209,1146,788,897,617,1514,2302,39.8720957,-77.2222427
01/01/2013 12:00:00 AM,42001,Central,South Central WDA,Adams,1,35 to 44 Years,Female,6413,627,2302,1225,812,867,580,1447,2259,39.8720957,-77.2222427
01/01/2013 12:00:00 AM,42001,Central,South Central WDA,Adams,1,25 to 34 Years,Female,5086,354,1515,1114,626,902,575,1477,2103,39.8720957,-77.2222427
01/01/2011 12:00:00 AM,42001,Central,South Central WDA,Adams,1,25 to 34 Years,Female,5172,339,1529,1255,674,818,557,1375,2049,39.8720957,-77.2222427
01/01/2010 12:00:00 AM,42001,Central,South Central WDA,Adams,1,25 to 34 Years,Female,5234,411,1698,1149,616,815,545,1360,1976,39.8720957,-77.2222427
01/01/2012 12:00:00 AM,42001,Central,South Central WDA,Adams,1,35 to 44 Years,Female,6753,656,2535,1319,807,914,522,1436,2243,39.8720957,-77.2222427
01/01/2010 12:00:00 AM,42001,Central,South Central WDA,Adams,1,35 to 44 Years,Female,7138,464,2910,1509,811,930,514,1444,2255,39.8720957,-77.2222427
01/01/2012 12:00:00 AM,42001,Central,South Central WDA,Adams,1,25 to 34 Years,Female,5102,327,1488,1253,683,847,504,1351,2034,39.8720957,-77.2222427
01/01/2011 12:00:00 AM,42001,Central,South Central WDA,Adams,1,35 to 44 Years,Female,6908,581,2657,1362,845,980,483,1463,2308,39.8720957,-77.2222427
01/01/2010 12:00:00 AM,42001,Central,South Central WDA,Adams,1,35 to 44 Years,Male,6937,968,3268,1188,420,616,477,1093,1513,39.8720957,-77.2222427
01/01/2014 12:00:00 AM,42001,Central,South Central WDA,Adams,1,25 to 34 Years,Female,5111,423,1529,1068,741,890,460,1350,2091,39.8720957,-77.2222427
01/01/2016 12:00:00 AM,42001,Central,South Central WDA,Adams,1,35 to 44 Years,Male,5771,675,2228,1024,616,782,446,1228,1844,39.8720957,-77.2222427
01/01/2015 12:00:00 AM,42001,Central,South Central WDA,Adams,1,25 to 34 Years,Female,5158,404,1637,947,674,1051,445,1496,2170,39.8720957,-77.2222427
01/01/2012 12:00:00 AM,42001,Central,South Central WDA,Adams,1,35 to 44 Years,Male,6517,895,2911,1025,511,754,421,1175,1686,39.8720957,-77.2222427
01/01/2011 12:00:00 AM,42001,Central,South Central WDA,Adams,1,35 to 44 Years,Male,6772,932,3100,1199,421,720,400,1120,1541,39.8720957,-77.2222427
01/01/2013 12:00:00 AM,42001,Central,South Central WDA,Adams,1,35 to 44 Years,Male,6338,777,2696,1035,604,833,393,1226,1830,39.8720957,-77.2222427
01/01/2015 12:00:00 AM,42001,Central,South Central WDA,Adams,1,35 to 44 Years,Male,5971,674,2439,1022,633,812,391,1203,1836,39.8720957,-77.2222427
01/01/2014 12:00:00 AM,42001,Central,South Central WDA,Adams,1,35 to 44 Years,Male,6148,721,2665,912,629,833,388,1221,1850,39.8720957,-77.2222427
01/01/2016 12:00:00 AM,42001,Central,South Central WDA,Adams,1,25 to 34 Years,Female,5232,437,1761,900,613,1161,360,1521,2134,39.8720957,-77.2222427
01/01/2016 12:00:00 AM,42001,Central,South Central WDA,Adams,1,25 to 34 Years,Male,5392,513,2378,1066,493,589,353,942,1435,39.8720957,-77.2222427
01/01/2015 12:00:00 AM,42001,Central,South Central WDA,Adams,1,25 to 34 Years,Male,5351,570,2432,1085,419,575,270,845,1264,39.8720957,-77.2222427
01/01/2010 12:00:00 AM,42001,Central,South Central WDA,Adams,1,25 to 34 Years,Male,5336,807,2193,780,544,753,259,1012,1556,39.8720957,-77.2222427
01/01/2011 12:00:00 AM,42001,Central,South Central WDA,Adams,1,25 to 34 Years,Male,5312,757,2358,898,437,648,214,862,1299,39.8720957,-77.2222427
01/01/2014 12:00:00 AM,42001,Central,South Central WDA,Adams,1,25 to 34 Years,Male,5247,739,2421,914,415,551,207,758,1173,39.8720957,-77.2222427
01/01/2012 12:00:00 AM,42001,Central,South Central WDA,Adams,1,25 to 34 Years,Male,5229,707,2378,949,392,599,204,803,1195,39.8720957,-77.2222427
01/01/2013 12:00:00 AM,42001,Central,South Central WDA,Adams,1,25 to 34 Years,Male,5211,840,2231,885,463,588,204,792,1255,39.8720957,-77.2222427
01/01/2016 12:00:00 AM,42059,Southwest,Southwest Corner WDA,Greene,30,45 to 64 Years,Female,5207,534,2379,820,396,636,442,1078,1474,39.8548039,-80.2294382
01/01/2015 12:00:00 AM,42059,Southwest,Southwest Corner WDA,Greene,30,45 to 64 Years,Female,5287,419,2405,850,453,732,428,1160,1613,39.8548039,-80.2294382
01/01/2011 12:00:00 AM,42059,Southwest,Southwest Corner WDA,Greene,30,45 to 64 Years,Female,5371,578,2666,715,416,568,428,996,1412,39.8548039,-80.2294382
01/01/2012 12:00:00 AM,42059,Southwest,Southwest Corner WDA,Greene,30,45 to 64 Years,Female,5432,564,2689,773,405,616,385,1001,1406,39.8548039,-80.2294382
01/01/2014 12:00:00 AM,42059,Southwest,Southwest Corner WDA,Greene,30,45 to 64 Years,Female,5298,491,2495,864,440,624,384,1008,1448,39.8548039,-80.2294382
01/01/2013 12:00:00 AM,42059,Southwest,Southwest Corner WDA,Greene,30,45 to 64 Years,Female,5355,586,2630,758,426,596,359,955,1381,39.8548039,-80.2294382
01/01/2010 12:00:00 AM,42059,Southwest,Southwest Corner WDA,Greene,30,45 to 64 Years,Female,5376,667,2670,798,416,492,333,825,1241,39.8548039,-80.2294382
01/01/2011 12:00:00 AM,42059,Southwest,Southwest Corner WDA,Greene,30,45 to 64 Years,Male,6001,583,3064,835,517,672,330,1002,1519,39.8548039,-80.2294382
01/01/2015 12:00:00 AM,42059,Southwest,Southwest Corner WDA,Greene,30,45 to 64 Years,Male,5751,597,3134,610,403,698,309,1007,1410,39.8548039,-80.2294382
01/01/2012 12:00:00 AM,42059,Southwest,Southwest Corner WDA,Greene,30,45 to 64 Years,Male,5877,631,3076,833,436,596,305,901,1337,39.8548039,-80.2294382
01/01/2010 12:00:00 AM,42059,Southwest,Southwest Corner WDA,Greene,30,45 to 64 Years,Male,5841,693,2909,847,360,728,304,1032,1392,39.8548039,-80.2294382
01/01/2014 12:00:00 AM,42059,Southwest,Southwest Corner WDA,Greene,30,45 to 64 Years,Male,5828,642,3070,729,384,735,268,1003,1387,39.8548039,-80.2294382
01/01/2016 12:00:00 AM,42059,Southwest,Southwest Corner WDA,Greene,30,45 to 64 Years,Male,5691,622,3241,637,313,653,225,878,1191,39.8548039,-80.2294382
01/01/2013 12:00:00 AM,42059,Southwest,Southwest Corner WDA,Greene,30,45 to 64 Years,Male,5861,652,3232,715,368,683,211,894,1262,39.8548039,-80.2294382
01/01/2014 12:00:00 AM,42059,Southwest,Southwest Corner WDA,Greene,30,25 to 34 Years,Female,1949,116,785,284,293,269,202,471,764,39.8548039,-80.2294382
01/01/2016 12:00:00 AM,42059,Southwest,Southwest Corner WDA,Greene,30,25 to 34 Years,Female,1976,99,707,443,198,331,198,529,727,39.8548039,-80.2294382
01/01/2012 12:00:00 AM,42059,Southwest,Southwest Corner WDA,Greene,30,35 to 44 Years,Female,2360,203,983,380,201,412,181,593,794,39.8548039,-80.2294382
01/01/2013 12:00:00 AM,42059,Southwest,Southwest Corner WDA,Greene,30,35 to 44 Years,Female,2314,250,852,408,196,430,178,608,804,39.8548039,-80.2294382
01/01/2015 12:00:00 AM,42059,Southwest,Southwest Corner WDA,Greene,30,25 to 34 Years,Female,1986,122,757,345,284,305,173,478,762,39.8548039,-80.2294382
01/01/2016 12:00:00 AM,42059,Southwest,Southwest Corner WDA,Greene,30,35 to 44 Years,Female,2161,161,865,359,318,299,159,458,776,39.8548039,-80.2294382
01/01/2014 12:00:00 AM,42059,Southwest,Southwest Corner WDA,Greene,30,35 to 44 Years,Female,2258,207,864,402,207,420,158,578,785,39.8548039,-80.2294382
01/01/2013 12:00:00 AM,42059,Southwest,Southwest Corner WDA,Greene,30,25 to 34 Years,Female,1950,92,834,284,339,243,158,401,740,39.8548039,-80.2294382
01/01/2015 12:00:00 AM,42059,Southwest,Southwest Corner WDA,Greene,30,35 to 44 Years,Female,2228,182,899,401,208,381,157,538,746,39.8548039,-80.2294382
01/01/2010 12:00:00 AM,42059,Southwest,Southwest Corner WDA,Greene,30,35 to 44 Years,Female,2416,178,1085,368,332,299,154,453,785,39.8548039,-80.2294382
01/01/2011 12:00:00 AM,42059,Southwest,Southwest Corner WDA,Greene,30,35 to 44 Years,Female,2365,171,1039,377,267,368,143,511,778,39.8548039,-80.2294382
01/01/2016 12:00:00 AM,42059,Southwest,Southwest Corner WDA,Greene,30,25 to 34 Years,Male,2648,393,1188,364,266,303,134,437,703,39.8548039,-80.2294382
01/01/2012 12:00:00 AM,42059,Southwest,Southwest Corner WDA,Greene,30,25 to 34 Years,Male,2615,375,1272,389,226,226,127,353,579,39.8548039,-80.2294382
01/01/2012 12:00:00 AM,42059,Southwest,Southwest Corner WDA,Greene,30,25 to 34 Years,Female,2007,126,814,322,338,288,119,407,745,39.8548039,-80.2294382
01/01/2011 12:00:00 AM,42059,Southwest,Southwest Corner WDA,Greene,30,25 to 34 Years,Male,2542,330,1240,440,170,248,114,362,532,39.8548039,-80.2294382
01/01/2010 12:00:00 AM,42059,Southwest,Southwest Corner WDA,Greene,30,25 to 34 Years,Female,2059,121,793,441,216,376,112,488,704,39.8548039,-80.2294382
01/01/2015 12:00:00 AM,42059,Southwest,Southwest Corner WDA,Greene,30,25 to 34 Years,Male,2578,382,1156,382,264,282,112,394,658,39.8548039,-80.2294382
01/01/2013 12:00:00 AM,42059,Southwest,Southwest Corner WDA,Greene,30,25 to 34 Years,Male,2672,431,1270,454,183,224,110,334,517,39.8548039,-80.2294382
01/01/2011 12:00:00 AM,42059,Southwest,Southwest Corner WDA,Greene,30,25 to 34 Years,Female,2005,115,812,340,340,289,109,398,738,39.8548039,-80.2294382
01/01/2014 12:00:00 AM,42059,Southwest,Southwest Corner WDA,Greene,30,35 to 44 Years,Male,2810,343,1475,491,164,231,106,337,501,39.8548039,-80.2294382
01/01/2014 12:00:00 AM,42059,Southwest,Southwest Corner WDA,Greene,30,25 to 34 Years,Male,2712,443,1196,405,199,365,104,469,668,39.8548039,-80.2294382
01/01/2010 12:00:00 AM,42059,Southwest,Southwest Corner WDA,Greene,30,25 to 34 Years,Male,2711,437,1250,412,219,291,102,393,612,39.8548039,-80.2294382
01/01/2016 12:00:00 AM,42059,Southwest,Southwest Corner WDA,Greene,30,35 to 44 Years,Male,2642,362,1323,472,142,246,97,343,485,39.8548039,-80.2294382
01/01/2013 12:00:00 AM,42059,Southwest,Southwest Corner WDA,Greene,30,35 to 44 Years,Male,2868,359,1532,485,165,232,95,327,492,39.8548039,-80.2294382
01/01/2015 12:00:00 AM,42059,Southwest,Southwest Corner WDA,Greene,30,35 to 44 Years,Male,2696,405,1323,491,147,242,88,330,477,39.8548039,-80.2294382
01/01/2012 12:00:00 AM,42059,Southwest,Southwest Corner WDA,Greene,30,35 to 44 Years,Male,2810,388,1538,420,138,243,83,326,464,39.8548039,-80.2294382
01/01/2011 12:00:00 AM,42059,Southwest,Southwest Corner WDA,Greene,30,35 to 44 Years,Male,3208,457,1648,573,152,301,77,378,530,39.8548039,-80.2294382
01/01/2010 12:00:00 AM,42059,Southwest,Southwest Corner WDA,Greene,30,35 to 44 Years,Male,2944,340,1565,532,141,292,74,366,507,39.8548039,-80.2294382
